  ####
 #    #
 #. * #
# . $  #
# #**# #
#  *+* #
 # $$ #
 #    #
  ####
