   ###
###   #
# $*@.###
# # *$  #
# #. .# #
# #$* $ #
#    .###
###   #
   ###
