    ##    ###
####  ####   #
# $  $     $ ###
# #   # ### #   #
#  $   $ # $$ $ #
 ##  ## $@$     #
  #$ ##  # $$ $$ #
  #    $  ## ##  #
 ### #$##  ...# #
 #  ..*.*..##.# #
 # #..*.....*.# #
 #   ########   #
  ###        ###
