    ###
   #  @###
  #  #$$  #
 ##.#   # #
#  $#.#$  #
#   ...  #
 ##$#.#$ #
  #     #
   ##   #
     ####
