    ####
####   #
#@$  # #
# $$$  #
##.#.  #
#  ..# #
#  #.* #
# $.$ #
 ##   #
 ######
