   ##
  #  #
  #  #  #####
  #  # #..   #
  # ####..##$##
  #  $ $.*     #
  # #$ #*.# $# #
 ##$#  #..#  # #
#   #$ #*.# $# #
# # #  $..#  # #
# #$#$ #..$  #  #
#   #  #..#   # #
# #@# $#*.#$# # #
#  $#  #..#   # #
 #   $ $ $ ###  #
  ###   #      #
     ### ######
