       ###
##### #   ###
#   ## $ $  #
# # ##    # #
# #..$ $ ## #
#  .$# $#   #
###..# $ @$ #
  #**# $ # ##
  #..#   # #
  #..##### ##
  #.*#   $  #
  #..# $    #
  ##.### #####
  # $      $ #
  #   ####   #
  #####  #####
