 ### ####
#   ##   # ###
# $   $ $ #   #
# $ #  .$ #   #
 ##  ##.#  $ #
# ##$##.###. #
#   *.......$#
#    ##.##   #
##$####.#####
#  $ # . #   #
#  #  **$    #
#  $ # @ # $ #
# $   ### #  #
 ##   #   ###
   ###
