       ##
     ##  ###
   ## $ $   #
  #   #..#$ #
  # $$#*.#  #
  #   ....$ #
  # # .#.#  #
 # $##$#.#$ #
 # @$    .$ #
  #  #  ##  #
   #####  ##
