 ##
#  ######
#        #
#  ###$# #
 #.# # . #
 # # #$* #
 #.### + #
 # $ #$* #
 # #   . #
 #.####* #
#  $ $ * #
#       ##
 ########
