######### 
#       # 
# ***** # 
# * . * ##
# *@#$*  #
# *   *  #
# ***** ##
#       # 
######### 
