######### 
#       # 
# ***** ##
# *   *  #
# *+#$*  #
# *   *  #
# ***** ##
#       # 
######### 
