 ################# 
 #       #       # 
 # ***** # ***** # 
## *   * # * . * ##
# $..$#* # * $ .$ #
#  *   * # * # *  #
## ***** # ***** ##
 #       #       # 
 ####### @ ####### 
 #       #       # 
 # ***** # ***** # 
## * # * # *   * ##
# $. $ * # *.$#.$ #
#  * . * # *   *  #
## ***** # ***** ##
 #       #       # 
 ################# 
