########## 
#        # 
# ****** # 
# *  . * ##
# *@*# *  #
# *  $ *  #
# ****** ##
#        # 
########## 
