######### 
#       # 
# ***** # 
# * $ * ##
# *.@.*  #
# * $ *  #
# ***** ##
#       # 
######### 
