######### 
#       # 
# ***** # 
# *   * ##
# *+*$*  #
# *   *  #
# ***** ##
#       # 
######### 
