  ##########################  
  #            #           #  
 ## ********** # ********* ## 
 #  .        * # *       .  # 
 # $********$* # *$*******$ # 
 ## .        * # *       . ## 
  # ********** # ********* #  
  #            #           #  
 #############   ############ 
 #             #            # 
 # *********** # ********** # 
## *       $ * # * @      * ##
# $* *******.* # *.******$*  #
#  *        .* # *        *  #
## *********** # ********** ##
 #             #            # 
 ############################ 
