######### 
#       # 
# ***** # 
# *   * ##
# *$#@*  #
# * . *  #
# ***** ##
#       # 
######### 
