 ##################### 
##*                  ##
# $**#*# #*#*# #*#*#  #
# #   * # *   *  *  * #
# *  *  *  *  * * $** #
# # *  *#*  * #*  * # #
# **  * * *  **  *  * #
# #  *  *  *  * *   # #
#  #*#**.**#*#.#*#**$ #
# #  *  *   * # *   # #
# **  * *  *  *  *  * #
# # *  *# *  *#*  * # #
# *  *  **  * * *  ** #
# #   * #  *  *  *  # #
# $**#*#.#*#**.**#*#  #
# #   * *  *  *   * # #
# *  *  **  * *  *  * #
# # *  *# *  *# *  *# #
# **$ * *  *  **  * * #
# *  *  *   * #  *  # #
#  #*#*# #*#*# #*#**+ #
##                   ##
 ##################### 
