######   ######
#    #####    #
# $.$  @  .$. #
# . .#####$ $ #
# $.$     .$. #
#    #####    #
######   ######
