#########
#       #
# $###$ #
#  # #  #
# $###$ #
#...@...#
# $###$ #
#  # #  #
#### ####
