#############
#.....#.....#
#.$$$$#$$$$.#
#.$@      $.#
#.$ $$$$$ $.#
#.$ $...$ $.#
### $. .$ ###
#.$ $...$ $.#
#.$ $$$$$ $.#
#.$       $.#
#.$$$$#$$$$.#
#.....#.....#
#############
