#############
#.....#.....#
#.@$     $ .#
#.$$$$ $$$$.#
#. $  $  $ .#
#. $  $  $ .#
##  $$ $$  ##
#. $  $  $ .#
#. $  $  $ .#
#.$$$$ $$$$.#
#. $     $ .#
#.....#.....#
#############
