#############
#.....#.....#
#.$$$$$$$$$.#
#.$@  #   $.#
#.$   $   $.#
#.$   #   $.#
##$#$###$#$##
#.$   #   $.#
#.$   $   $.#
#.$   #   $.#
#.$$$$$$$$$.#
#.....#.....#
#############
