#########
##  #  ##
##  @  ##
#. $#$ .#
#.$ # $.#
#$ $#$ $#
#.$ # $.#
#.. # ..#
#########
