#############################
#          ... ...          #
# $$$$$$$$$...@...$$$$$$$$$ #
#          ... ...          #
#############################
