###########
#    @    #
# $  $  $ #
# $$$$$$$ #
#..  $  ..#
#...#.#...#
#####.#####
#...#.#...#
#..$ $ $..#
# $$$ $$$ #
#  $ $ $  #
#         #
###########
