########
##   .##
# .$@$ #
#.$$$$.#
# $..###
# $ .  #
# .$$$.#
## . .##
########
