#######
#. @ .#
# * $ #
# $#$ #
# $ * #
#.   .#
#######
