#####  ####
#   ####  #
# $     $ #
## #####  #
 # #  .# ##
 # #..@   #
## #  .## #
#  ###### #
# $     $ #
#  ####   #
####  #####
