        ###
       ## ##
      ##   ##
     ## $.$ ##
######  .$.  ######
#   # $.$.$.$ #   #
#     .$.@.$.     #
#   # $.$.$.$ #   #
######  .$.  ######
     ## $.$ ##
      ##   ##
       ## ##
        ###
