#############
###.#.#.#.###
#  $ $ $ $ .#
# $ $ $ $ $##
##.#.#.#.$ .#
######### $.#
##.#.#.#.$ .#
#@$ $ $ $ $##
#  $ $ $ $ .#
###.#.#.#.###
#############
