         #####
       ### $.##
     ### * $* ##
   ###  *  $.  #
  ##.. * * $.$ ##
####.@* *  $.$ ##
  ##.. * * $.$ ##
   ###  *  $.  #
     ### * $* ##
       ### $.##
         #####
