#####   #######
#   #   #     #
# # ##### # # #
#  .$ @   #   #
###.####### ###
#  .    $ # #
# # ###   # #
# # $ ##### #
# # #       #
# # #########
#   #
#####
