   ###########
   #  * * *  #
####   * *   ########
#     * * *  #  # # #
#      * *      $   #
## #  * * *  # # # ##
 # #   * *   #      #
## #  * * *  ## # # #
#  ###########      #
#       +        # ##
#####################
