#############
# . $ . $ . #
# $ . $ . $ #
#@### # ### #
# $ . $ . $ #
# . $ . $ . #
#############
