 ###########
 #         #
 # $ $ # #.#
 #$$$$ # #.#
 #  $  # #.##
 # $ $ #@#. #
 # #######  #
 # #        #
 # # # # # ###
##.#       ###
# .#######  #
#...        #
#########   #
        #####
