#########
#   #   #
# $. .$ #
#   #   #
## ###@##
#   #   #
# $. .$ #
#   #   #
#########
