#####
#   #  #####
# * ####   #   #######
#  *     * #   #     #
### ####   #   #     #
  # #  ## ##   #$$$$##
  # #   # #    #    #
 ## ##  #.#    #    #
 # * ####.#### #$$$$#
 # *   ..... # #    #
 #   ####.#### # $ @#
 #####  #.#    # ####
        # ######  #
        #         #
        #  ########
        ####
