###########
#         #
#  $...$  #
##$ .@. $##
#  $...$  #
#   $.$   #
##$.....$##
#   $.$   #
#  $.$.$  #
##$.$ $.$##
#         #
###########
