#############
#           #
# #$####... #
# #.$  $.@. #
# #. $  ... #
# #$  $  $# #
# #.$  $  # #
# #. $  $ # #
# #$  $  $# #
# . $..$..$ #
# $.####### #
#           #
#############
