 ####
## .##
#... #
#... #######
###.##     #
 #..   $ $ #
 #  ##$ $# #
 ##@ $ $ # #
  # $ $  # #
  # #$ $ # #
  # # # ## #
  # # #    #
  #   ######
  #####
