#######        #######
#    .#        #     #
#  $$ ##########.$$  #
#   $.   ....   .$  @#
#  $$ ##########.$$  #
#    .#        #     #
#######        #######
