 ####
 #  ########
 # $ $     #
 # #.#.#$#$#
 # # # #   #
 # #. .  #$#
##   # #   ##
#  #.#.  #$ #
#    @ #    #
#####  #  ###
    #######
