 #####   #####   #####
##   ## ##   ## ##   ##
# $ $ ###     ### $ $ #
#  $  .....@.....  $  #
# $ $ ###     ### $ $ #
##   ## ##   ## ##   ##
 #####   #####   #####
