    ###
   #   #
  #  .  #
 #  * *  #
#  * * *  #
# * * * * #
#  * * *  #
 #  * *  #
  #  $  #
   # @ #
    ###
