 #####   #####   #####
##   ## ##...## ##   ##
# $ $ ###.$$$.### $ $ #
#      ...$@$...      #
# $ $ ###.$$$.### $ $ #
##   ## ##...## ##   ##
 #####   #####   #####
