 #########
##   .   ##
#  $ . $  #
# $#$.$#$ #
#  $ . $  #
#....@....#
#  $ . $  #
# $#$.$#$ #
#  $ . $  #
##   .   ##
 #########
