     #####
     #   ###
 ##### #   #
 # ....### #
## $$$ $ # #
#  $ $$$ # #
# ##....@# #
#  ####### #
##         #
 ###########
