     ###
   ##. .##
  # .*.*. #
 # .*.*.*. #
 #.*.*.*.*.#
# * * * * * #
#  $ $ $ $  #
# $ $ $ $ $ #
 # $ $ $ $ #
 #    $    #
  #       #
   ## @ ##
     ###
