###########
#    @    #
# $ $ $ $ #
##       ##
 ## $ $ ##
  ##...##
   ##.##
    #.#
    #.#
    #.#
    #.#
   ##.##
  ##...##
 ## $ $ ##
##       ##
# $ $ $ $ #
#         #
###########
