 ##########
##  #  *  #####
#   # * * #   #
# @  * $ *  . #
#   # * * #   #
##  #  *  #####
 ##########
