 #### # #    ####
##  ##########  ##
#                #
#  #  #########  #
## #####******# ##
 # #   ########  #
 # #    $.@.$    #
## #   #######  ##
#  ######   ######
#          $##***#
##  ##### #  #***#
#####   #$   #####
#  #. .    ###   #
## #########   ###
