#####
#  .##
#  #.##
##$ *.##
#  $ *.##
# * $ #.#
# $* $  #
#@   #  #
#########
