 #########
 #       #
## #$#$#$##
# $       #
#   .#. # #
#.#.###.#.#
# # .#.   #
#       $ #
##$#$#$# ##
 #@      #
 #########
