###########
#    @    #
# ******* #
# *     * #
# * $ $ * #
# *$ $ $* #
# * $ $ * #
# *     * #
# ******* #
# ....... #
###########
