  #####
  #   #
###$ $###
# $...$ #
#  . .  #
# $...$ #
###$ $###
 #. . .#
 # $$$ #
 #.$@$.#
 # $$$ #
 #. . .#
 #######
