########################
#              #       #
# *###*###*##* # # # # #
# #          # # # * # #
# # *###*##* # * # # # #
# # #      # # # # # # #
# # # *### # * # * # * #
# # * #  +$# # # # # # #
# # # # #**  # * # # # #
# * # * # ###* # # # # #
# # # # #      # # * # #
# # * # *##*###* # # # #
# # # #          # # * #
# * # *##*###*###* # # #
# # #              # # #
# # *######*#######* # #
# #                  # #
# *####*#######*#####* #
#                      #
########################
