###############
#      @      #
# $ $ $ $ $ $ #
## $ $ $ $ $ ##
##  $ $ $ $  ##
##   $ $ $   ##
######$.$######
######.$.######
##   . . .   ##
##  . . . .  ##
## . . . . . ##
##. . . . . .##
###############
