    ####
 ####  #
 #  $  ###
 #  #    #
 #@ #    #
##### ####
#     . #
#  #    #
#  #### ##
#        #
#  ### # #
#### #   #
     #####
