#############
#           #
# +******** #
# *       * #
# * ***** * #
# * *   * * #
# * *   * * #
# * *   * * #
# * ***** * #
# *       * #
# ********$ #
#           #
#############
