  #####
###   ###
#   $   #
# $$$$$ #
#   $   #
### $# ##     #######
  #  # #      #. .  #
  # $# #      #. .  #
  #  # #      #. .  #
  #$## ########. .  #
  # #          . .  #
  # #    ######.##@##
  # #### #    #.    #
  # $ $  #    #######
  #     ##
  #######
