############
#  .$ .$   #
# *.$ .$ *@#
#  .$ .$   #
#$$$########
#...#
#   #
#$$$########
#...$. $.  #
# * $. $.* #
#   $. $.  #
########$$$#
       #...#
       #   #
########$$$#
#  .$ .$...#
# *.$ .$ * #
#  .$ .$   #
############
