 ####
 #  #####
 #$ $ $ #
 # ...  #
##$.$.$##
#  ... #
# $ @ $#
#####  #
    ####
