#############
#   * # *   #
# * * # *   #
#  $* @ **. #
# * * # *   #
#   * # *   #
#############
