#########
#@      #
#   $   #
# $$$$$ #
#   $   #
# $$$$$ #
#   $   #
#### ####
   # #
   # #
 ### ###
 # ... #
 # ... #
 # ... #
 # ..  #
 # ..  #
 #######
