  #   #   #
  #   #   #
 ############   #
 #       #  ## #
## $*$*$  . ###
##       #..##
###$#$#$#*..+#
##       #..##
## $*$*$  . ###
 #       #  ## #
 ############   #
  #   #   #
  #   #   #
