########
#..  ..#
#.$$$$.#
# $  $ #
# $@ $ #
#.$$$$.#
#..  ..#
########
