#########
#.....  #
#    $# #
#.... # #
#   $$# #
#...  # #
#  $$$# #
#..   #@#
# $$$$###
#.     #
#$$$$$ #
#      #
########
