    ###############
    #      *      #
##### ##### ##### #####
#   # #   # #   # #   #
# $   #     #     # + #
#   # #   # #   # #   #
## ## ## ## ## ## ## ##
 # #   # #   # #   # #
 # #     #     #     #
 # #   # #   # #   # #
 # ##### ##### ##### #
 #   *           *   #
 #####################
