    #######
    #     #
    # @.. #
    #   # #
###### ########
#   #     #   #
# $## ... # $ #
# $   *.*   $ #
# $ # ... ##$ #
#   #     #   #
####### #######
    # #   #
    # $$$ #
    #     #
    #######
