#############
#           #
#$ $ $.$ $ $#
# $ $.$.$ $ #
# #$.$.$.$# #
# #.$.$.$.# #
# . .$+$. . #
#. . .$. . .#
#############
