 ####
 #  ###
## $  #
#  $  #
#+.*..#
#  $  #
## $  #
 #  ###
 ####
