 ##########
##  #  *  #####
#   # * * #   #
# +  * $ *    #
#   # * * #   #
##  #  *  #####
 ##########
