####################
##................##
#  ##  $    ..    @#
# ####$ $###..###  #
# #### $ # #..###  #
#  ##    ###..#    #
# $ $ $########$$$ #
#  $ $   ###  #  $ #
# $ $ $  ###  #  $ #
#  $ $ $ # # $$$$  #
##  #  # # #      ##
####################
