###################
#@     ..##       #
# $$$$ .... $$$$  #
#      ##..       #
###################
