####
#  #######
#        #
#  #$$$$$#
# ##.....#
#  #     #
## #### ##
# *   #  #
#   #   @#
##########
