      ###
     # # #
    ## . ##
   ##  . ###
  ###$#.#   #
 ## .*. ...##
#    $#.#   #
# $$$ $*$ ##
#   @$ .###
 ### $  ##
  ## $ ##
   #   #
    ###
