#########
#@  .   #
#  $.$  #
# $$.$$ #
#...*...#
# $$.$$ #
#  $.$  #
#   .   #
#########
