####
#  #######
#        #
#  ##### ###
#*##   #   #
#  #   # # #
#  * $ # # #
## # # # # #
 # # . # # #
 # #   * # #
 # # @ # # #
 #     # # #
 ####*#### #
    #      #
    ########
