 #####
##   ##
#  #  #
#.$@$.#
# $$$ #
#. . .#
#######
