    ####     #
   #   #    #
  ## # #####
 ###  .... # #
######.$$$ ##
     #.$@$ #
     #.$$$ # #
     #    .##
     #######
         #
       ###
