#######
#.... #
# $$$ #
# $@$ #
# $$$ #
# ....#
#######
