  #######
  #  @  #
  # # # #
  #     #
  # ### #
  #  .  #
  ### ###
    #.#
##### #####
#. $   $ .#
# # .$. # #
# #$$$$$# #
# #  $  # #
# #  $  # #
###.###.###
  # # # #
  # # # #
  # # # #
  # # # #
  #.# #.#
  ### ###
