#########
#    .$ #
#$$$$.$ #
#.....$ #
# $.@.$ #
# $.....#
# $.$$$$#
# $.    #
#########
