#########
#.. $ ..#
#. @$  .#
#.$ $ $.#
#$$$*$$$#
#.$ $ $.#
#.  $  .#
#.. $ ..#
#########
