#############################
#   $  $  $... ... $  $  $  #
#  $  $  $ ...@...$  $  $   #
#   $  $  $... ... $  $  $  #
#############################
