#########
#  * * ##
#  $ $  #
# .*.*. #
#  $@$  #
# .*.*. #
#  $ $  #
## * *  #
#########
