                           ########
                        ####      #
                     ####    #### #
                  ####    #### @# #
               ####    ####  # $  #
            ####    ####  #    .###
         ####    ####  #     #    #
      ####    ####  #     #  #### #
   ####    ####  #     #  ####    #
####    ####  #     #  ####    ####
#    ####  #     #  ####    ####
# ####  #     #  ####    ####
# #  #     #  ####    ####
# #     #  ####    ####
# #.$#  ####    ####
# #  ####    ####
# ####    ####
#      ####
########
