########
#      ####
# ####    ####
# #  ####    ####
# #+$#  ####    ####
# #     #  ####    ####
# #  #     #  ####    ####
# ####  #     #  ####    ####
#    ####  #     #  ####    ####
####    ####  #     #  ####    ####
   ####    ####  #     #  ####    #
      ####    ####  #     #  #### #
         ####    ####  #     #    #
            ####    ####  #     ###
               ####    ####  #    #
                  ####    ####  # #
                     ####    #### #
                        ####      #
                           ########
