       ####
########  #
#       * #
#  #####  #
# *    # ##
#  # *    #
##### ##  #
#     ##  #
#@$$..#####
#     #
#######
