##########
#        #
# $ $ $$ #
###### $ #
   ##    #
  ##... ##
 ##.+..##
## ...##
#    ##
# $ ######
# $$ $ $ #
#        #
##########
