     #####
 #####   ############
 #                  #
 # ###   ########## #
 # # ## ##        # #
 # #  # #   ##### # #
 # #  #$#####   # # #
##### #. .$   @ # # #
#   ###   ###   # # #
#     $. .# ##### # #
#   ####$##  # #  # #
#####  # ##### #### #
       #            #
       ##############
