     #####
 #####   #
 #       #
 # ###   #
 # #*## ##
## ##*#$#*#####
#   ###.###   #
#    $.@.$    #
#   ###.###   #
#####*#$#*#####
     ## ##
     #   #
     #   #
     #   #
     #####
