##########
#    ##  #
# $ . ## #
#  . . ###
# . . $ ##
## . $ $ #
### $ @  #
# ## $  ##
#  ##  ###
##########
