###############
#      @      #
# ***     *** #
# * $$$$$$$ * #
# * ....... * #
# *********** #
#             #
###############
