##########
#  . . . #
#  $ $ $ #
## #######
#        #
#@       #
####### ##
# $ $ $  #
# . . .  #
##########
