#######
#.... #
#      #
##.... #
 #  #  ##
 ##$$$$ #
  #     ##
  # $$$$ #
   #    @#
   #######
