###########
#.  $.$  .#
# . $.$ . #
#  .$.$.  #
#$$$$.$$$$#
#....@....#
#$$$$.$$$$#
#  .$.$.  #
# . $.$ . #
#.  $.$  .#
###########
