     #####
    ##.####
  ###.$@$.###
  ##.$$.$$.##
 ##.$$.#.$$.##
##.$$.###.$$.##
## $.## ##.$$.#
##$.##   ##.$##
#.$$.## ##.$ ##
##.$$.###.$$.##
 ##.$$.#.$$.##
  ##.$$.$$.##
  ###. $$.###
    ####.##
     #####
