#######
#    ##
# $$$ #
# $...#
#@$$$.#
# $...#
# $$$.#
## ...#
#######
