############
#@         #
# $$$$.... #
# $...$$$. #
# $.$$..$. #
# $.$  .$. #
# .$.  $.$ #
# .$..$$.$ #
# .$$$...$ #
# ....$$$$ #
#          #
############
