 ######
 ######
  # .#
  #$.#
  # .#
  #$.#
  # .#
 ##$.##
### .###
## $  ##
## $@ ##
## $$ ##
##    ##
 ######
