####  #####
#  ####   #
#       @ #####
#  ##  #$##   #
#     ## .    #
##### #### ####
#          #
#   ####   #
#####  #####
