##############
#     #......#
# $$  # .....#
#     # . ...#
##$$$###$#####
#     $      #
#  $$$#$$$$$ #
#     #    @ #
##############
