      #####
      #   #
      # $ #
      #   #
      ## ##
       #.#
##### ## ## #####
#   ### . ###   #
# $     @     $ #
#   ### . ###   #
##### ## ## #####
       #.#
######## ########
# * * *   * * * #
#       $       #
##  * *   * *  ##
#################
