##########
#        #
# $ $ $.$###
# $ $ $.$  #
#######.##@##
    # ....  #
    # #.#   #
    #     ###
    #######
