    #####
    # @ #
  ### $ ###
 ##  .$.  ##
##  $.$.$  ##
#  .$.$.$.  #
# $.$.$.$.$ #
#.$.$.$.$.$.#
#############
