#############
#*.*.#      #
#.+..#$$$$$ #
#*.*..      #
#.....$ $ $ #
#..##########
#$ $ #
#  $ #
#$ $ #
#  $ #
#$ $ #
#    #
######
