  #########
   ##     #
# ##  .$$.#
###  .$$. #
##  .$$. ##
#  .$$. ###
# .$$. ## #
#.$$. ##
#@$. ##
########
