#############
#..  ...  ..#
#.$$$$$$$$$.#
#.$   @   $.#
#.$$$$$$$$$.#
#..  ...  ..#
#############
