 #####
 #   ####
 # .$   #
## # $# #
#.$.$ # #
# #$ $# #
#.$. .# #
#   ### #
###.#   #
  #   @ #
  #######
