 ###############
 #             ####
## #############  #
# . . . . . .     #
# $ $ $ $ $ $ #   #
#  ############# ##
####@            #
   ###############
