  ###########
  # *  *  * #
### *  *  * ###
#   *  *  *   #
# + ******* $ #
#   *  *  *   #
### *  *  * ###
  # *  *  * #
  ###########
