 #######
##. . .##
#.$$$$$.#
##.$@$.##
#.$$$$$.#
##. . .##
 #######
