#################
##      @      ##
## ########### ##
##$$.#######   ##
##.$$.#####  $ ##
###.$$.###  $ ###
####.$$.#  $ ####
#####.$$. $ #####
######.$$. ######
###### .$$.######
##### . .$$.#####
#### .  #.$$.####
### .  ###.$$.###
## .  #####.$$.##
#    #######.$$.#
#   #########.  #
# ############# #
#               #
#################
