     ####
######  ##
#      @ #
# # # #  #
# $ # . *#
# # # #  #
# $ # . *#
# # # #  #
# $   . *#
# # # #  #
##########
