#############
#   ##     ##
#  * # $$$ ##
## # # $ . ##
#  # # ... ##
# $# ####*###
# .#  ##    #
##   *@#  # #
######      #
#############
