  ############
  #   $ . . .#
###  $# ## $ #
# #   #  ### #
#### ###*#   #
 # # # *   # #
 ###   # ### #
   # ###  #  #
   # $ ##$#$ #
   #. . +    #
   ###########
