##########
# @      #
#$ $  $ $#
# $ $$ $ #
#  $  $  #
#   $$   #
#  $  $  #
# $ $$ $ #
#$ $  $ $#
#........#
#.  ..  .#
#.  ..  .#
#........#
#........#
#.      .#
#.      .#
#........#
#$ $  $ $#
# $ $$ $ #
#  $  $  #
#   $$   #
#  $  $  #
# $ $$ $ #
#$ $  $ $#
#        #
##########
