#   #               ########
##  ##         ####### .$  #
### ###  ######## *  # .$  #
########### $.  # *  # .$  #
#   # $.  # $.  # *  # .$  #
#@$ . $.    $.    *    .$  #
############################
