    #########
    #       #
 #### ##### #
 #   .    # #
 # #####  # #
 #$  .  $ # #
## ##### ## #
# $  .  $#@ #
#  ##### # ##
#    .   # #
##### #### #
    #      #
    ########
