 #######
#  . .  #
# $$$$$ #
#.$...$.#
# $.*.$ #
#.$...$.#
# $$$$$ #
#  . . @#
 #######
