    #####
    #   #
  ### . ###
  #  $$$  #
### ..... ###
#  $.$$$.$  #
# .$.$@$.$. #
#  $.$$$.$  #
### ..... ###
  #  $$$  #
  ### . ###
    #   #
    #####
