#########
#       #
# $ $ $ #
#  # #  #
# $ $ $ #
#  # #  #
# $ $ $ #
#       #
####@####
# ..... #
#  ...  #
#   .   #
#########
