#############
#          @#
# *.$ # $.* #
# *$* # *** #
# *.* # *.$ #
#     #     #
# ######### #
#     #     #
# *.* # $.$ #
# **$ # *** #
# $.* # *.* #
#           #
#############
