          #########
          #       #
          # $$$$$ #
          #       #
          #### ####
#########    # #
# # . . #    # #    #####
#   . . ###### ######   ##
# # . .       @         ###
# # . . ###### ######   ##
# # . .      # #    #####
# #######    # #
#       # #### ####
####### ###       #
      #     $$$$$ #
      #####       #
          #########
