#########
#.. $ ..#
#..$ $..#
# $ $ $ #
#$ $@$ $#
# $ $ $ #
#..$ $..#
#.. $ ..#
#########
