###########
#   .  #  #
##  #$    #
#  $ .#$  #
#  #    #.#
# $. # .$ #
#.#    #  #
#  $#. $ ##
#    $#   #
#@ #  .   #
###########
