##########
#       @#
# $##### #
#  #...# #
# $$...# #
#  #...$ #
# $##$## #
#  $ $ $ #
#        #
##########
