#####
#   #####
# $ $ $ #
## ...  #
##$.@.$##
#  ... #
# $ $ $#
#####  #
    ####
