 ####
 #  ########
 #   $     #
 # #  .#$#$#
 #  .# #   #
 # #  .  #$#
##  .# #   ##
#  # #.  #$ #
#    @ #    #
#####  #  ###
    #######
