      #############
      #  *  *  *  #
#######  *  *  *  #######
#@  *    *  *  *    $  .#
#######  *  *  *  #######
      #  *  *  *  #
      #############
