#########
#       #
# . . . #
#  $$$  #
# .$@$. #
#  $$$  #
# . . . #
#       #
#########
