#################
#               #
# ############# #
# #           # #
# # ######### # #
# # #       # # #
# # # ##### # # #
# # #$#.  # # # #
# #   @ # # # # #
# ##### # # # # #
#       # # # # #
######### # # # #
#         # # # #
# ######### # # #
#           # # #
############# # #
#             # #
# ############# #
#               #
#################
