  #####   #####
 ##*#*## ##*#*##
#################
##.............##
# ............. #
# $$$$$$$$$$$$$ #
##             ##
 ## $$$$$$$$$ ##
  ##         ##
   ## $$$$$ ##
    ##     ##
     ##   ##
      ##+##
       ###
        #
