#################
##  #  ###  #  ##
#  $ $  #  $ $  #
# $ # $ # $ # $ #
# $ # $ # $ # $ #
# $ #.$ # $.# $ #
# $ #.. # ..# $ #
# $ #.......# $ #
#   #...+...#   #
#################
