      #######
      #  @  #
      # # # #
      #     #
      # ### #
      #     #
      ###.###
        #.#
#########.#########
#..    $   $    ..#
####### $ $ #######
      #$ $ $#
      # $ $ #
      #$   $#
      # ### #
      # # # #
      # # # #
      # # # #
      #.# #.#
      #.# #.#
      ### ###
