#############
#     #     #
# *.*   *.* #
# $*$ # $*$ #
# *.* # *.* #
#     #     #
## ####### ##
#    @#     #
# *.* # *.* #
# $*$ # $*$ #
# *.*   *.* #
#     #     #
#############
