#######
# ..  #
#.$$$ #
#.$@$.#
# $$$.#
#  .. #
#######
