########
#      #
# @  $##
#   $. #
#   $$ #
#  $.. #
#  $.$##
#  **. #
#  **$ #
# $... #
# $..$##
# $.$. #
# $.$$ #
# **.. #
# **.$##
# ***. #
# **** #
########
