###########
#         #
# *.* *.* #
# $*$ $*$ #
# *.* *.* #
#         #
# *.* *.* #
# $*$ $*$ ##
# *.* *.*  #
#        @ #
########   #
       #####
