#########
#   @   #
# ##### #
# $   $ #
#  $$$  #
# $   $ #
#.## ##.#
#. . . .#
#   .   #
#########
