###########
#.   *   .#
# #$#$#$# #
# $  @  $ #
# #.#.#.# #
#    *    #
###########
