#############
#           #
# $$$$$$$$$ #
# $.......$ #
# $.$$$$$.$ #
# $.$...$.$ #
# $.$. .$.$ #
# $.$...$.$ #
# $.$$$$$.$ #
# $.......$ #
# $$$$$$$$$ #
#           #
###### ######
#           #
# ......... #
# .$$$$$$$. #
# .$.....$. #
# .$.$$$.$. #
# .$.$@$.$. #
# .$.$$$.$. #
# .$.....$. #
# .$$$$$$$. #
# ......... #
#           #
#############
