#########################
#     #*****#    *#     #
# ... #*   *# * * #     #
# ...  *   *   *   *****#
# ..  #*   *# * * #     #
#     #*****#*    #     #
### ################# ###
#  *  # *   #*    #  $  #
# *   # * * # * * # $ $ #
#*   *    *   **   $  $ #
# * * # * * # * * # $$$ #
#  *  #   * #    *#    @#
#########################
