    #####
   ## @ ##
  ##  #  ##
 ##  $ $  ##
##  # # #  ##
#..* $ $ *..#
# # # # # # #
#..* $ $ *..#
##  # # #  ##
 ##  $ $  ##
  ##  #  ##
   ##   ##
    #####
