###############
#@    #       #
# $.$ # $.$.$ #
# .#.   .# #. #
# $.$ # $ $ $ #
#     # .# #. #
### ### $.$.$ #
# $$$ #       #
#     #########
#    $  $.....#
# $$$$  $.*.*.#
#    $  $.....#
###############
