  ########
  #      #
  #      #
 ###$## ###
 #   #    #
 #   #    #
###$####$##
#    #    #
#    #    #
##$####$###
 #   .....#
 #   @    #
 ##########
