###########
#    @    #
#$$$$$$$$$#
#         #
#  * * *  #
# * * * * #
#* * * * *#
# * * * * #
#  * * *  #
#         #
#.........#
#         #
###########
