###########
#  #   #  #
#  *   *  #
#  ##@##  #
#.##   ##.#
#  $ * $  #
#.##   ##.#
#  ##$##  #
#$ *   *  #
#  #   #  #
###########
