#############################
# $  $  $  ... ...$  $  $   #
#  $  $  $ ...@... $  $  $  #
#   $  $  $... ...  $  $  $ #
#############################
