   ####
   # @#
   #  ####
####$   .#
#.   $####
# ##$   .#
#.   $####
####$   .#
   #  ####
   #  #
   ####
