    ###############
    #             #
##### ##### ##### #####
#   # #   # #   # #   #
# $   #     #     # + #
#   # #   # #   # #   #
## ## ## ## ## ## ## ##
 # #   # #   # #   # #
 # #     #     #     #
 # #   # #   # #   # #
 # ##### ##### ##### #
 #                   #
 #####################
