###########
#         #
#  #.#.#  #
# $.$ $.$ #
#  # # #  #
# $.$ $.$ #
#  #.#.#  #
#    @    #
###########
