#####
# @ #
#.$.#
#$.$#
#.$.#
# $ #
#   #
#   #
#####
