   ######
   #    #
   #    #
####$$$$####
#  $....$  #
#  $.+..$  #
#  $....$  #
#  $....$  #
####$$$$####
   #    #
   #    #
   ######
