      ####
      #  #
      #  #
      #  #
#######$.#######
#  . . .$ $ $  #
#  $ $ $. . .  #
#######.$#######
      #  #
      #.$#
  #   #  #   #
  #   #.$#   #
##### #  # #####
  #   #.$#   #
  #   #  #   #
  #   # @#   #
  #  ######  #
  # ######## #
  ############
  ############
 ##############
################
