###############
##     #     ##
# @ ... $$$   #
#  .  .#$  $  #
# .   . $   $ #
# .   .#$   $ #
# ....   $$$$ #
## # # # # # ##
# $$$$   .... #
# $   $#.   . #
# $   $ .   . #
#  $  $#.  .  #
#   $$$ ...   #
##     #     ##
###############
