  ##   ##
 #  # #  #
# $  #  $ #
#  $ . $  #
 #  *.*  #
  #..@..#
 #  *.*  #
#  $ . $  #
# $  #  $ #
 #  # #  #
  ##   ##
