#             #
 ##  #####  ##
  ####   ####
   ###* *###
   #  $.$  #
   #  . .  #
   ## $.$ ##
    ## @ ##
     #####
      ###
       #
       #
