          #####
       ####   ##
       #    $  #
  #    # $ $$$$##
   #   # $$$    #
#   #  # @$  $$ #
 ## #  # $$$$   #
   ##### $    $ #
   ##..#.####$ ##
   ##..........#    #
   ##......   ######
    ###############
