##########
#.......@#
# $##.#$ #
#  $     #
## ##$#$##
#  #  #  #
# $$  $  #
#  #  #  #
##########
