   ##########
  ##    #   #
 ##  @    $ #
 # $$$$$##$##
 # $    .# #
 #  ###..# ##
 # ## ...#  ##
 #   ....# $ #
#####..### $ #
#      # $$  #
#           ##
#############
