   #####
   # @ #
   #   #
####$ $####
#  $...$  #
#   .*.   #
#  $...$  #
####$ $####
   #   #
   #   #
   #####
