##############
#            #
#  # # # # # #
# ********$+ #
#            #
##############
