             #
            #@#
           #   #
          #  $  #
         ## $ $ ##
        ## $  #$ ##
       ## $  #  $ ##
      ## $  #..  $  #
     ## $  #.... #$  #
    ## $  #.. ..#  $  #
   ## $  # ....#  $  #
  #  $  #.. ..#  $  #
 #  $  #.... #  $ ##
#  $  #.. ..#  $ ##
 #  $# ....#  $ ##
  #  $  ..#  $ ##
   ## $  #  $ ##
    ## $   $ ##
     ## $ $ ##
      #  $  #
       #   #
        # #
         #
