#######################
####################  #
#          $         .#
#@$$$$$$$$$$..........#
#           ###########
#######################
