 ####
##  #########
#  $ $ $ $@ #
#  . . . .  #
##  #########
 ####     # #
