     ######
     #    #
     # $$ #
     #    #
     ### ##
       # #  #####
       # #  #   #
########.#### $ #
#      .+.      #
# $ ####.##### ##
#   #  # #   # #
#####  # #   # #
      ## ##  # #
      #   #### #
      # $$    .#
      #   ######
      #####
