  ###
 ##.##
##...##
#..$..#
#. $ .#
#  #  #
#  $  #
## $ ##
#  $  #
# #$# #
#  $  #
## $ ##
#  $  #
#  #  #
#  $  #
 # @ #
  ###
