###########
#         #
#         #
# ....... #
# ....... #
#####$#####
#   $ $   #
#  $ $ $  #
#   $ $   #
#  $ $ $  #
#   $ $   #
##### #####
#    $    #
#         #
#    @    #
#         #
###########
