 #########
###########
#         #
# $.$ $.$ #
# .$.$.$. #
# $.$ $.$ #
##  $.$  ##
## $.+.$ ##
 ## $.$ ##
 ## $ $ ##
 #...*...#
 #$$$$$$$#
 #.......#
  #     #
  #######
