 ##########
##  #. $ .#
#   # $.$ #
# @  $.$.$#
#   # $.$ #
##  #. $ .#
 ###### ###
     #   #
     # . #
     #   #
     #####
