#########
#       #######
# $$$$$ #.....#
# $...$ #.$$$.#
# $.$.$  .$+$.#
# $...$ #.$$$.#
# $$$$$ #.....#
#       #######
#########
