     #####
   ##     ##
  #         #
 #  # # # #  #
 #  #.# #.#  #
#   ### ###   #
#             #
# $    @    $ #
#  $$     $$  #
#  ..$$$$$..  #
 #  *.....*  #
 #   *****   #
  #         #
   ##     ##
     #####
