########################
#                      #
# #$################## #
# #                  # #
# # #$############## # #
# # #              $ $@#
# # # ############ # # #
# # # #..........$ $ # #
# # # ############ # # #
# # $              # # #
# # ##############$# # #
# $                  # #
# ##################$# #
#                      #
########################
