   #####
####   #
#.$ $  #
#..$ $##
#...$ @#
#..$ $##
#.$ $  #
####   #
   #####
