 #######
 #. . .#
## $$$ ##
#.*$@$*.#
## $$$ ##
 #. . .#
 #######
