      #####
      #   #
      # $ #
      #   #
      ## ########
       # #      #
#####  #.$   ## #
#   ####.#####  #
# $    .+.    $ #
#   ####.#### $ #
#####  # #  #   #
       # #  #####
      ## ##
      #   #
      # $ #
      #   #
      #####
