###########
#    @    #
# $ $ $ $ #
#  $ $ $  #
# $ $ $ $ #
#####$#####
# ... ... #
# ... ... #
#         #
#         #
###########
