##########
#   #..$ ##
# $ #.*$  ##
# $ #..$  ##
# @ $..$  ##
# $ #..$  ##
# $ #.*$  ##
#   #..$ ##
##########
