#################
#       @       #
# $ $ $ $ $ $ $ #
#  $ $ $ $ $ $  #
##  $ $ * $ $  ##
 ##  $ * * $  ##
  ####* * *####
 ##  . * * .  ##
##  . . * . .  ##
#  . . . . . .  #
# . . . . . . . #
#################
