      ###
#######.#######
#     .*.     #
#@$$$$.*.$$$$ #
#     .*.     #
#######.#######
      ###
