############
#          #
#********  #
#.      *  #
#****** *  #
#     * *  #####
##### * *      #
    # * *******#
    # *      $@#
    # *  ******#
    # ****     #
    #          #
    ############
