 #######
 #     #
 #$$.$$#
## ... ##
# $.*.$ #
#  ...  #
##$$.$$##
 #  @  #
 #######
