##### ####### #####
#   ###  #  ###   #
#.@$ #       #    #
###  #  ###  #  ###
 ## ### ### ### ##
 #  ###  #  ###  #
 #       #       #
 ##  #  ###  #  ##
  ####### #######
