############
#          #
# *******$ #
# *        #
# * ****** #
# * *    * #
# * * +* * #
# * *  * * #
# * **** * #
# *      * #
# ******** #
#          #
############
