   #
  #.#
 #.$.#
#.$$$.#
 # $ #
 # @ #
 #####
