          #
         ###
        ##.##
       ##.$.##
      ##.$.$.##
     ##.$.$.$.##
    ##.$.$.$.$.##
   ##.$.$ $ $.$.##
  ##.$.$.$ $.$.$.##
 ##.$.$ $ $ $ $.$.##
##.$.$.$ $@$ $.$.$.##
 ##.$.$ $ $ $ $.$.##
  ##.$.$.$ $.$.$.##
   ##.$.$ $ $.$.##
    ##.$.$.$.$.##
     ##.$.$.$.##
      ##.$.$.##
       ##.$.##
        ##.##
         ###
          #
