   ##########
####  . . . #
#   $ $ $ $ #
#.$.@.#######
#   $ $ $ $ #
####  . . . #
   ##########
