#######
#  $ .#
# * * #
#+ $  #
# * * #
#  $ .#
#######
