   #########
   #       #
   #       #
####$$$ $$$####
#             #
#$$$$$$$$$$$$$#
#.............#
#......@......#
#.............#
#$$$$$$$$$$$$$#
#             #
####$$$ $$$####
   #       #
   #       #
   #########
