   ###
 ###.#
 #.$$##
###@$.#
#.$$###
##$.#
 #.##
 ###
