############
#  $.$.$.  #
#  .$.$.$  #
#  $.$.$.  #
#@ .$.$.$  #
#  $.$.$.  #
#  .$.$.$  #
#  $.$.$.  #
############
