 # # # # ###
         #  #
####### # *  #
#. . .## *   #
# $$$ # * *  #
#.$@$.   * $.#
# $$$ # * *  #
#. . .## *   #
####### # *  #
         #  #
 # # # # ###
