         #
         ##
        ###
        # ##
       ## ###
       ##   ##
     #### # ###
    ###     #
      # # #+###
      #      ###
    #####  # #
   ###       #
     # # # #####
     #        ###
   ##### ## # #
  ###         #
    # # ### #####
    #          ###
  ##### #### # #
 ###           #
   # # ##### #####
   #            ###
 ##### ###### # #
###             #
  # #$####### ###
 ##             ##
###################
       #####
       #####
      #######
