 #######
 #*.*.*#
 #.*.*.#
 #*.*.*#
 #.*.*.#
 #*.*.*#
 # $.$ #
 #  $  #
####@####
#       #
# $ $ $ #
## $ $ ##
 #$ $ $#
 # $ $ #
 #     #
 #######
