###############
#  $..$ $..$  #
#  $..$ $..$  #
#  $..$@$..$  #
#  $..$ $..$  #
#  $..$ $..$  #
###############
