 #######
 #     #
 #$$.$$#
## ... ##
# $...$ #
#  ...  #
##$$ $$##
 #  @  #
 #######
