#####################
#     #       #     #
####### ##### #######
#      .     .      #
# ##### ##### ##### #
# #   # #   # #   # #
# # $ # # $ # # $ # #
# #   # #   # #   # #
# ## ## ## ## ## ## #
#  # #   # #   # #  #
#. # # $ # # $ # # .#
#  # #   # #   # #  #
# $# ##### ##### #$ #
# . .     .     . . #
# $# ##### ##### #$ #
#  #      @      #  #
#####################
