    #####
  ###   #
  #*# $ ###
#####   #*#
#   #@######
# $ #..    #
#    ..# $ #
###### #   #
 #*#   #####
 ### $ #*#
   #   ###
   #####
