   #####
   #   ###
 ### $ #*#
 #*#   #####
###### #   #
# *  ..# $ #
# $ #..  * #
#   #@######
#####   #*#
  #*# $ ###
  ###   #
    #####
