########
#..$ ..#
#.$  $.#
#$ ##$ #
# $## $#
#.$  $.#
#.. $..#
#####..#
#@$ $$$#
#      #
########
