####
#. ##
#.. #######
# ..  # @ #
## .      ##
 ## # ###  #
  # #  #   #
  #  $$#$$ #
  #  # #   #
  #   $ $ ##
  ##      #
   ########
