  #####
  #   ##
  # #  #
  # $.$###
####.$.  #
#  $..$# #
#  $$... #
#  $.$ ###
#  # # #
#### @ #
   #####
