#####
#...#
#$$$#
#   #
#.$.#
#$@$#
#.$.#
#   #
#$$$#
#...#
#####
