    #####
    #   #
##### $ #
#   # $ #
# $$...####
#   .@.   #
####...$$ #
  # $ #   #
  # $ #####
  #   #
  #####
