#####    #####
#   ######   #
# $          #
#  $ $ $ $ $ #
## ######### #
# *.*.*... # #
# .....*.* #@#
######### ## #
# $ $ $ $  # #
#        $ # #
#   #####    #
#####   ######
