####################
#  * . #  .$  *.  *#
#$   # *     *   $ #
# . $   $*#. $. #  #
#  .# * # .  # $  .#
# $ * .* *  # #$ # #
#* * $  #  * .  . *#
# * # $ .*@ $ #$*# #
#.  .  $  #   . * .#
# $ * $ # . $   $  #
##   #.$ .*  # $* ##
#  #    #  $.   . .#
# $ $ .* $#   $ #  #
#* *   #    .  *  *#
####################
