#######
#  #  #
# *$* #
# ... #
# $*$ #
#  @  #
# $*$ #
# ... #
# *$* #
#  #  #
#######
