   #####
   # @ #
   #   #
####$ $####
#  $   $  #
#....*....#
#  $   $  #
####$ $####
   #   #
   #   #
   #####
