#######
#     ####
# $ $ #  #
#  * ##  #
# $ * .  #
#### * +##
   #. *  #
   #   * #
   #######
