      ####
 ###### .#
 #  .$ $ #
 # $  $ .#
##$.$. .$#
# $  @$. ##
#. $.$ $. #
###.  .####
  # ####
  ###
