##########
# . . .  #
# $ $ $  #
####### *#
#@$ $ $  #
# . . .  #
##########
