 ###########
#############
##         ##
#           #
## $$$$$$$ ##
 ##       ##
  ## $$$ ##
   ##   ##
######@######
   #.....#
####.....####
   #     #
####     ####
   #######
    #####
