        #####
      ###.  #
    ###. .$ #
  ###. .$.$ #
###. .$.$.$ #
#. .$.$.$.$ #
# $ $ $ $ $ #
##########@ #
         ####
