#############
# .   @   . #
#.# # # # #.#
# $ # # # $ #
# # $ # $ # #
# # # $ # # #
# # $ # $ # #
# $ # # # $ #
# # # # # # #
#.  . . .  .#
#############
