  #######
  # ....#
###$$$$.#
# * *  .#
# # # $.#
# @ * $ #
# # # $ #
#     ###
#######
