 #     ##########
##     # .$.$.  ##
##     # $.$.$   #
########@.$ $.   #######
##     # $.$.$   #      #
##     # .$.$.  ##
 #     ##########        #
                         #
