    ##########
  ###..$ $   #
###.....$ $  #
#+.....# $ $ #
#......#$ $  #
#....### $ $##
#..###  $ $ #
#### $ $ $ $#
# $ $ $ $ $ #
#  $ $ $ $  #
#           #
#############
