##############
#            #
# ########## #
# #        # #
# # ###### # #
# # #    # # #
# # # ## # # #
# # #$.# # # #
# #    # # # #
# #### # # # #
#      # # # #
######## # # #
#        # # #
#@######## # #
#          # #
#*########## #
#            #
##############
