  #####
  #   #
###$ $###
# $...$ #
#  .@.  #
# $...$ #
###$ $###
  #   #
  #####
