           ######
############  * #      #####
#.  @  $      * ########   #
############  *            #
           #  * ########   #
           ######      #####
