##########
# . $. $ #
# $ .$ . #
# ..$.$$@#
# $ .$ . #
# . $. $ #
##########
