#######
#   # ## ###
#   ###### ##
##       ########
 #$$$ $ $..*..*.#
 # @$$$$$..*..*.#
 #$$$ $ $..*..*.#
 #       ########
 ###  #### ##
  ##  #  ###
   ####
