#########
#       #
# . # $ #
## .#$ ##
 #. @ $#
## .#$ ##
# . # $ #
#       #
#########
