#######
# .@. #
#$$$$$#
# $ $ #
#.....#
#######
