##############
#@           #
# $$$$$..... #
# $ . $. $ . #
# $...$.$$$. #
# $ . $. $ . #
# $$$$$..... #
# .....$$$$$ #
# . $ .$ . $ #
# .$$$.$...$ #
# . $ .$ . $ #
# .....$$$$$ #
#            #
##############
