###################
#        @        #
# $$$$$$$$$$$$$$$ #
# $.............$ #
# $.$$$$$$$$$$$.$ #
# $.$.........$.$ #
# $.$.........$.$ #
# $.$..$$$$$..$.$ #
# $.$..$...$..$.$ #
# $.$..$. .$..$.$ #
# $.$..$...$..$.$ #
# $.$..$$$$$..$.$ #
# $.$.........$.$ #
# $.$.........$.$ #
# $.$$$$$$$$$$$.$ #
# $.............$ #
# $$$$$$$$$$$$$$$ #
#                 #
###################
