###############
#          .  #
# ######### # #
# .   *    .  #
###$$$$$$$#+###
# .   *    .  #
# ######### # #
#          .  #
###############
