  ########
  #@  #  ##
### $$$ $ #
#   $...# ###
# $...#...$ #
### #...$   #
  # $ $$$ ###
  ##  #   #
   ########
