    ####
    #  #
    #  #
    #  #
###### #
#      #
#   # .#
##### ###
    # #@#
    # # #
    #$# #
    #   #
    #####
