#######
#@. $ #
# . $ #
# .*$ #
# $*. #
# $ . #
# $ . #
#######
