###########
#@. $ . $ #
# . $ . $ #
# .*$*.*$ #
# $*.*$*. #
# $ . $ . #
# $ . $ . #
###########
