 ###########
##  $...$  ##
#  $$...$$  #
#   $...$   #
#  $$.@.$$  #
#   $...$   #
#  $$...$$  #
##  $...$  ##
 ###########
