#######
#     #
#     #
#$$$$$#
#.....#
#.....#
#$$$$$#
#  @  #
#######
