      #####   ####
      #   #####  ##
      # . . . .   #
   ##### ##       #
   #   #  #### ####
   # .  . #      #
##### ##  #      #
#   #  ####      #
# .  . #  ###### #
## ##  #  $ $    #
 # #####$ $ $ # ##
 #. .#  $ $ $    #
 # .  $ $ $ $ $# #
 #. .#    #     @#
 #################
