    #####
    #   #
    #$.$#
    #. .#
#####$.$#####
# $.$   $.$ #
# . . @ . . #
# $.$   $.$ #
#####$.$#####
    #. .#
    #$.$#
    #   #
    #####
