#############
#. . . .  @ #
#.$.$.$.$ # #
#.$.$.$.$ # #
# $ $ $ $ # #
######### # #
#           #
#############
