##########
#       @#
#$$$$$$$ #
#......$ #
#......$ #
#$$$$..$ #
#   $..$ #
# # $..$ #
#   $..$ #
##########
