############
#          #
# $$$##. $ #
#  @ #.# #.#
# $$$#.# #.#
#    #.# #.#
# $$$..$ #.#
#    #   #.#
############
