            ####
            #  #
 ############* #
##             #
#@$  ##### #  ##
#### #   # ##*#
 #  *  * #  # #
 # # # #### # #
 #   # *  * # #
 #####  # # # ###
    # * #       #
    #   #####.# #
    #  ##   #   #
    ####    #####
