     ####
######  #
#   ##$ #
# $. .  #
### @ ###
# $. .  #
#   ##$ #
######  #
     ####
