#############
# .   $   . #
# # ##### # #
# $   @   $ #
# # ##### # #
# .   $   . #
#############
