         #
         ##
        ###
        #@##
       ## ###
       ##   ##
     ####$# ###
    ###   $ #
      # #$#$###
      #   $  ###
    #####  # #
   ###       #
     # # # #####
     #        ###
   ##### ## # #
  ###  .....  #
    # # ### #####
    #  .....   ###
  ##### #### # #
 ###         $ #
   # #$##### #####
   #         $  ###
 #####$###### # #
###          $  #
  # # ####### ###
 ##             ##
###################
       #####
       #####
      #######
