 #######
##  #  ##
#  $$$  #
#..$+$..#
#..$.$..#
#  $$$  #
##  #  ##
 #######
