##########
#  $.$.  #
# . .$ $ #
#@.$$..$ #
# . .$ $ #
#  $.$.  #
##########
