##########
#  $..@  #
# $ .. $ #
# $####$ #
# $ .. $ #
#   ..$  #
##########
