#############
##         ##
# #  $ $  # #
#  *******  #
#  *. $ .*  #
# $* ... *$ #
#  *$.@.$*  #
# $* ... *$ #
#  *. $ .*  #
#  *******  #
# #  $ $  # #
##         ##
#############
