#################
#@              #
##########  $$$ #
        #  $$  #
       #  $$  #
   #####.$$.##
  ##....**...##
  ##...**....##
   ## $$ #####
  #  $$  #
 #  $$  #
#  $   #
#     #
######
