##############
#@           #
# .$*.$*.$*. #
# *        $ #
# $ ###### * #
##. #    # .##
# * ###### $ #
# $        * #
# .*$.*$.*$. #
#            #
##############
