#########
#  . .  #
# .$.$. #
#.$$$$$.#
# .$@$. #
#.$$$$$.#
# .$.$. #
#  . .  #
#########
