 #####
 #   #####
 # # #   #
 # $ .$# #
###.##   #
#   ##.###
# #$. $ #
#   # # #
#####  @#
    #####
