#######
#     #
# *.* #
# *+$ #
# $** #
#     #
#######
