#########
#    ####
# ## ####
#  .$.###
# #$@$###
# #.$.  #
# # ### #
#       #
#########
