###############
#   *     *   #
# ## ## ## ## #
# #     #     #
#   $#     # +#
# ## ## ## ## #
#   *     *   #
###############
