###############
#     ..*     #
#  $$$.*.$$$  #
#     *..    @#
###############
