#############
#     #     #
# $.$ # $.$ #
# .#. * .#. #
# $.$ # $.$ #
#     #@    #
###*#####*###
#     #     #
# $.$ # $.$ #
# .#. * .#. #
# $.$ # $.$ #
#     #     #
#############
