####################################
#@                                 #
#.***$****$*$$*$****$***$$****$*$$.#
#.    .  . . .. .  . . .  .  . .. .#
#.***$*$$*$***$$*$$*$****$****$*$*.#
#   . .  . . .. .  . .  . .  . .  .#
#.***$****$*$$*$****$****$*$$*$*$$.#
#                                  #
####################################
