#########
##  #  ##
# $ $ $ #
#  .+.  #
##$.#.$##
#  ...  #
# $ $ $ #
##  #  ##
#########
