     ###
    ## ##
   ##   ###
  ##      #
 ## $*$*$ ##
##  *...*  ##
#   $.@.$   #
##  *...*  ##
 ## $*$*$ ##
  ##     ##
   ##   ##
    ## ##
     ###
