  #######
  #     #
  # # # #
  #  @  #
### # # ###
# # # # # #
# #.#.#.# #
# $ $ $ $ #
# #.#.#.# #
# $ $ $ $ #
# #.#.#.# #
# $ $ $ $ #
# #.#.#.# #
#         #
###########
