  #####
  #   #
###$ $###
# $...$ #
#       #
# $...$ #
### @ ###
# $...$ #
#       #
# $...$ #
###$ $###
  #   #
  #####
