#############
#     *     #
# $  * *  . #
#   * * *   #
#  * * * *  #
# * * * * * #
#* * *@* * *#
# * * * * * #
#  * * * *  #
#   * * *   #
# .  * *  $ #
#     *     #
#############
