  #########
  #   #   #
###.# #.# ###
#   $ # $   #
# # #.# #.# #
# $ $ # $ $ #
###.# #.# ###
  #   @   #
  #########
