##### #####
#...###   #
#...    @ #
#. .###   #
### # # ###
  #$# #$#
### # # ###
#   # #   #
# $ # # $ #
# $ # # $ #
# $ # # $ #
#   # #   #
##### #####
