  #######
  #. $ .#
### $.$ ###
#@ $.$.$ .#
### $.$ ###
  #. $ .#
  #######
