  #####
 #.   .#
#..$$$..#
# $$.$$ #
# $.@.$ #
# $$.$$ #
#..$$$..#
 #.   .#
  #####
