        ###
#####   #.#####
#@$.# ###$  $.#
## ####.# ## ####
 #$ $.#$ $.#$ $.#
 #.# ## ####.# ####
 ###$  $.#.###$ $.#
   #.#####$$.#.# ##
  ####      #### #
  #. $ $###.#.$ $#
  ##$## #.#### #.#
   #.#.$ $#.$ $###
   ###### ## #.#
       #.$  $###
       #####.#
           ###
