        #####
        #   #
  ####### # #
  #         #
### ### ### #
#   # # # # #
# #$### ###$###
#    $ @ $    #
###$#######$# #
  # .......   #
  # ####### ###
  #    $    #
  # # #######
  #   #
  #####
