#######
#     #
# $$$ #
# $@$ #
# $$$ #
#.....#
#*...*#
#######
