#################
#@  $.  $.  $.  #
# $.  $.  $.  $ #
##############. #
#.$  .$  .$  .$ #
#  .$  .$  .$   #
#$$##############
# .$.  $.  $.   #
#.   $.  $.  $. #
############## $#
# ..$  .$  .$  .#
#.$  .$  .$  .$ #
#  ##############
# $.  $.  $.  $ #
#   $.  $.  $.  #
#################
