############
####    ####
###  $$  ###
### $..$@###
#  $$..$$  #
# $......$ #
# $......$ #
#  $$..$$  #
## $....$ ##
##$..$$..$##
## $$  $$ ##
##        ##
############
