##############
#     #.   $@#
# $  #.$.    #
#   #.$.$.#$ #
# $#.$.$.#   #
#    .$.#  $ #
# $   .#     #
##############
