###############
#      #      #
# $  $ $ $  $ #
# $$.$$$$$.$$ #
#  $$.....$$  #
# $$.......$$ #
# $..$...$..$ #
# ........... #
# .$.......$. #
# .$.$$$$$.$. #
##$$$..$..$$$##
# $ $$ $ $$ $ #
#      @      #
###############
