   #          #
  # #        # #
 # $.#      #.$ #
# .$$.#    #.$$. #
 # .$$.#  #.$$. #
  # .$$.##.$$. #
   # .$$  $$. #
    # .$  $. #
     #  @   #
     #      #
     ##$$$$##
      #    #
      # $$ #
      #....#
      #....#
      ######
