#######
#@    #
# $ $ # ####
#   $ # #  ##
# $$$$###   #
#   $.....  #
#####.###.###
    #.# #.#
    #.###.#####
    #.....$   #
    #####$$$$ #
        # $   #
        # $ $ #
        #     #
        #######
