            ###
         ####  #  ##
      ####     # #..#
   ####    $## # #..#
 ###    $## #  # #  #
#    $## #  #  # #  #
# $## #  #  #   #   #
## #  #  #  #       #
#  #  #  ####      #
#  #  ####        #
#  ####          #
####           ##
 #@         ###
  ##########
