#######
#     #
# * * #
#* $ *#
# *.* #
#  @  #
#######
