#############
#   *   *   #
# $ * * * $ #
#   *   *   #
#***********#
#   *   *   #
# . * + * . #
#   *   *   #
#***********#
#   *   *   #
# * * $ * * #
#   *   *   #
#############
