#####
# @ #
#$.$#
#.$.#
#   #
#   #
#####
