###########
#  . . . .#
# .$.$.$.$#
# $.$.$.$.#
# .$.$.$.$#
# $ $ $ $ #
#######  @#
      #####
