##################################
#  *. $. $. *. $. #   $...$  $   #
#@ $  $  $ .$  $     $ ... $  $  #
#  $. *. $. $. *. # $  ...  $  $ #
##################################
