   #####
  ##   ##
 ## $.$ ##
##  .$.  ##
# $.$.$.$ #
# .$.@.$. #
# $.$.$.$ #
##  .$.  ##
 ## $.$ ##
  ##   ##
   #####
