##########
#        #
# $ $ $  #
#######*@#
# * * *  #
# . . .  #
##########
