###############
#      #      #
# $$$$$ ..... #
# $ . $#. $ . #
#@$...$ .$$$. #
# $ . $#. $ . #
# $$$$$ ..... #
#      #      #
###############
