######       #####
#    #       #   #
#  $ #       # $ #
#  $ ######### $ #
#  $ ....+.... $ #
#  $ ######### $ #
#  $ #       #   #
#    #       #####
######
