     ########
######     @#
#      #$## #
# #$## #. $ #
# # .$ $ .# #
# $. # ## # ##
# ## #..     #
#     ..# ## #
## # ## # .$ #
 # #. $ $. # #
 # $ .# ##$# #
 # ##$#      #
 #      ######
 ########
