       ############
       #          #
       # ######## #
    #### #   #  # #
    #    #   $  # #
    # #####$##  # #
 #### #   #  #.## #
 #    #   $  #.#  #
 # #####$##  #.# ##
## #   #  ####.# #
#  #   $  #  #.# #
# ###$##  #  #.# #
#   #  #######.# #
#   $  #       # #
##@##  #       # #
#   ####       * #
#              # #
##################
