###############
##.. . . . ..##
 ## $  @  $ ##
  ## $$$$$ ##
   ##     ##
    ##   ##
     ## ##
      ###
