#########
#. . .  #
#.$.$.$ #
#.$.$.$ #
# $ $ $ #
###### @#
     ####
