#########
# . . . #
# .@. $ #
# . $ $ #
# $ $ $ #
######  #
     ####
