###########
#. . .  @ #
#.$.$.$ # #
#.$.$.$ # #
# $ $ $ # #
# ####### #
#         #
###########
