#############
#  #  #@ #  #
#  #  #  #  #
# $#$ # $#$ ####
#   ..$.. ..$  #
#  $.. ..$..   #
#### $#$ # $#$ #
   #  #  #  #  #
   #  #  #  #  #
   #############
