       ####
######## @####
#... $  $ ...###
#### $$#   ### #
   #   # $##     #
 # ###### ##### ##
 #  # #     #.# #
###   # $ $ #.####
#.# ### $ $ #.#  #
#.# #    $       #
#.### ###### $ # #
#     #    ## ## #
#  $ ## ####   # ##
# $$ #  #...$     #
##   ## ####      #
 #####     ########
