########
#      #
# $ $  #
# $ $ .#
#####..#
# $ $.*#
# @....#
# $ $.*#
#####..#
# $ $ .#
# $ $  #
#      #
########
