        ######
        #    #
        # $  #
        #  $ #
##########$  #
#      # # $ #
# #### ###  $#
# #  #     $ #
# # *####### #######
#   *    @   ......#
####*  #############
   # * #
   #   #
   #####
