########
#@     #
#...$$$#
# #  # #
#$$$...#
# #  # #
# #  # #
# #### #
#      #
########
