###############
# .    @    . #
# .$ $ $ $ $. #
##.#########.##
# .$ $ $ $ $. #
# .         . #
###############
