 ####
 #  #   ####
 #  #####  ####
 #         #  #
###*##### * * #
##  ##  ####  #
# * ##  #  *  #
#       #     #
#  ###*#####*##
#### #    #   #
 #   *    #   #
 # * ### #### #
 ##  * #    $@#
  #    #  ###.#
  ######### ###
