      ############
      #         .#
 ###### #######.##
##       #      .##
#@$  # $   $ # $ .#
### ####### #######
  #          #
  ############
