     #####
     #   #
     # $ #
     #   #
    ### ###
#####  .  #####
#   # $.$ #   #
# $  ..@..  $ #
#   # $.$ #   #
#####  .  #####
    ### ###
     #   #
     # $ #
     #   #
     #####
