#######
# .@. #
# $$$ #
#..$..#
# $$$ #
#..$..#
# $$$ #
#..$..#
# $$$ #
#..$..#
# $$$ #
#..$..#
# $$$ #
#  .  #
#######
