      #######
      #     #
####### # # #
#. . .$$ $ $##
# # # # #.#  #
#.*.*..$ $$$@#
# # # # #.#  #
#. . .$$ $ $##
####### # # #
      #     #
      #######
