 #########
## #.#.#.##
#@$ $ $ $.#
## # #*#.##
 # * * $ #
 # # # # #
 #       #
 #########
