#########
#       #
# $$$$* #
# $   . #
# $ ##. #
# $ ##. #
# *.... #
#      @#
#########
