    #######
    #  @  #
##### ### #####
# .  $   $  . #
# ### ### ### #
# .  $   $  . #
##### ### #####
    #     #
    #######
