##########
#. . . . #
#$.$.$.$.#
#.$.$.$.$#
#$.$.$.$.#
# $ $ $ $#
#    @   #
##########
