##############
#@           #
# .....$$$$$ #
# .$ $.$. .$ #
# . $ .$ . $ #
# .$ $.$. .$ #
# .....$$$$$ #
# $$$$$..... #
# $. .$.$ $. #
# $ . $. $ . #
# $. .$.$ $. #
# $$$$$..... #
#            #
##############
