 ########
 #  @   #
 #$ $ $ #
 # #.####
## ...  ##
#  #.#   #
#  $ $   #
#######  #
      ####
