###########################
#    #       #       #    #
# ******* ******* ******* #
# *     . *     * .     * #
# * $$$ . *  @  * . $$$ * #
##* $   . .     . .   $ *##
# * $ ******* ******* $ * #
# *   * * . . . . * *   * #
# ***.*** ******* ***.*** #
#     *     * *     *     #
##### * $$$ * * $$$ * #####
    # *     . .     * #
    # ******* ******* #
    #    #       #    #
    ###################
