  #####
  # . #
###$.$###
# $   $ #
#.. @ ..#
# $   $ #
###$.$###
  # . #
  #####
