  #####
  #   #
###$.$###
# $   $ #
#...@...#
# $   $ #
###$.$###
  #   #
  #####
