#######
#... .#
#.$$$ #
#.$@$ #
# $$$ #
#.   .#
#######
