  #####
  #   #
###$.$###
# $ . $ #
# ..@.. #
# $ . $ #
###$.$###
  #   #
  #####
