#########
#   #   #
# # # $ #
#    ** #
# # **  #
#  ** # #
# **    #
# + # # #
#   #   #
#########
