#######
#     #
# $ $ #
#**@**#
# . . #
#     #
#######
