    #####
   ##   ##
 #### $ ####
#####   #####
#   ## ##   #
#  $     $  #
# $ ## ## $ #
## ###.### ##
##  # . ## ##
#   ..+..  ##
#   # . ## ##
## ###.### ##
# $ #   # $ #
#  $  #  $  #
#   #####   #
#####   #####
 ####   ####
   ##   ##
    #####
