  #####
  #   #
  # # ###########
  #  ........   #
##### #######$$ #
#   #       # $ #
# @ # $ $ $ # $ #
##          # $ #
##  ######  #   #
 ####    ########
