############
#       # @#
#  #### #  #
#  #  # #  #
#  #  # #  #
#  ####    #######
#     ..####     #
#  ###..     $ $ #
###### ######    #
#    # #    ######
#    # #    #
#  ### ###  #
#           #
#  # $ $ #  #
#  #     #  #
#############
