  #########
 ##   @   ##
## .$.$.$. ##
# .$$$.$$$. #
# ...$ $... #
# .$$$.$$$. #
## .$.$.$. ##
 ##       ##
  #########
