   #                 #
  #.#       #       #.#
 #*$.#     #.#     #.$*#
#.$ $.#   #.$.#   #.$ $.#
 #.$ $.# #.$@$.# #.$ $.#
  #.$ $.#.$ $ $.#.$ $.#
   #.$ $*$ $.$ $*$ $.#
    #.$ $ $.#.$ $ $.#
     #.$ $.# #.$ $.#
      #.$.#   #.$.#
       #.#     #.#
        #       #
