#########
# #...# #
# * . * #
# * * * #
# * $ * #
# #$$$# #
#   @   #
#########
