      #######
#######  .  #######
#     # $.$ #     #
# $ $  ..@..  $ $ #
#     # $.$ #     #
#######  .  #######
      #######
