#########
#...#...#
#...#...#
#$$$#$$$#
#   #   #
#   #   #
#$$$#$$$#
#   #   #
##  #  ##
#   #   #
#       #
#  #@#  #
#########
