    #######
    #   $.#
##### #####
#    *    #
#   * *   #
#  * * *  #
# * * * * #
#* * * * *#
# * * * * #
#  * * *  #
#   * *   #
#    *    #
##### #####
#@    #
#######
