  #######
  #   # #
  #   . #
  # #*  #
  # * # #
###*  # #
# *  ## #
# $#    #
# @######
####
