#############
#    .+.    #
# $$$***$$$ #
#    ...    #
#############
