#################
#               #
# $.$.$.$.$.$.$ #
# .$.$.$.$.$.$. #
# $.$.$.$.$.$.$ #
# .$.$.$.$.$.$. #
# $.$.#####.$.$ #
# .$.$#   #$.$. #
# $.$.#   #.$.$ #
# .$.$#   #$.$. #
# $.$.#####.$.$ #
# .$.$.$.$.$.$. #
# $.$.$.$.$.$.$ #
# .$.$.$.$.$.$. #
# $.$.$.$.$.$.$ #
#              @#
#################
