####
#  #### #####
# *   ###   #
#  #        #
## ##*#### ##
 #    #### #
 # ##* $.# #
 #    #### ##
 # ##.####  #
 #  @$      #
 #########  #
         ####
