  #####
 ##   #
 #  #$###
 # . *  #
 # ..*  #
###. .# #
#@$$$ $ #
#   #####
#####
