##########
#   ##   ##
#    $    #
##$## ... #
#  $ #*#.##
#    *+#.#
#  $$##  #
#  #  #$ #
####   $ #
   # .####
   ####
