 ##########
##   ##  .#
# $  ##*#.##
#  $   .*. #
#   $ #.$. #
### $ #*#  #
  ###$#   ##
    #  # ##
    ## @ #
     #####
