      #####
#######   #
#  #@$    #
# . *$#$$ #
# *.  #  ##
##  # $ ##
 ##.**# .#
  #.     #
  ##  #  #
   #######
