   #####
   #   #
####$$ ###
# $ .# * #
#  #. .  #
#  . *#$ #
##. #.$@##
 ##$   ##
  #   ##
  #####
