    #####
 ####   #
 # $@*  ####
## ### ##  #
# $.#  #.  #
#    $ $   #
# .* #. ** #
###  #   ###
  ########
