###########
#    .  $@#
#  *# #*  #
##  *.. ###
 #$ #.#$ #
 #  $.$  #
 #  ###  #
 #### ####
