 ########
 #      #
##$* * $#
# $. .#.#
#@$.#. .#
##$*$*  #
 #      #
 ########
