##########
#   #@   #
#   ***# ###
## #.*.#$  #
 # # *.    #
 #  #.### ##
 #  #     #
 #  $ $#  #
 #### $ ###
    #   #
    #####
