   #####
  ##   ####
 ##  #$$  #
 #  #   *@#
 # ##.#$###
##  ... ###
#  .#*#   #
#   $ $ # #
#### .  $ #
   ###  ###
     ####
