#####
#   ####
#    $ #
##  $# ##
 # #..* ##
 #.*. # @#
 ##$# *$##
  #   $. ##
  ##   $. #
   ####   #
      #####
