   #####
####   ##
#  #$   #
# . .$. #
# .$* * #
## .*.$##
 # $#$ #
 ## @  #
  ######
