   ####
  ##  #
  # . #
  #   ##
#### . #####
#  # #   $@#
# $  * #$$ #
#  . #$.. ##
##*# . $ ##
 #   #####
 #####
