   #########
   # . # . #
   #. *#* .#
#### *   * ####
#   #  $  #   #
#. * * $$* * .#
# *  $*@*   * #
### $$ # $$ ###
# *   * *$  * #
#. * *$$ * * .#
#   #  $  #   #
#### *   * ####
   #. *#* .#
   # . # . #
   #########
