 ####### #######
 #  #  # #  #  #
 #  # $###$ #  #
##  #   #   #  ##
#.***.$ # $.***.#
##    #####    ##
#  ## #   # ##  #
# ### #$$ #*### #
#@ .**  .   ..  #
# ### # $$#*### #
#  ## #   # ##  #
##    #####    ##
#.***.$ # $.***.#
##  #   #   #  ##
 #  # $###$ #  #
 #  #  # #  #  #
 ####### #######
