#######   #######
#     #####     #
#.***  $.$  ***.#
#   ##  $  **   #
###  ###$###  ###
  ##    *    ##
######     ######
#     ##.##     #
#.***   *   ***.#
#   ## $ $ ##   #
###  ###*###  ###
  ##    @    ##
   ###########
