  #####   #####
###   #####   ###
# $ # $ # $ # $ #
# *   * * *   * #
#.** **. .** *#.#
#     #   *     #
########@########
#     #   *     #
#.#* **. .** **.#
# *   * * *   * #
# $ # $ # $ # $ #
###   #####   ###
  #####   #####
