  #############
###           ###
#  $##$#.#$##$  #
# $  * * * *  $ #
##.............##
# $ * # # # * $ #
#  $#$#$#$#$#$  #
###     @     ###
  #############
