#############
#  #  #  #  #
#    $$$    #
#  *  $  *  #
#*#*#####*#*#
#  *  #  *  #
# #  .+.  # #
#..**#$#**..#
# #  .*.  # #
#  *  #  *  #
#*#*#####*#*#
#  *  $  *  #
#    $$$    #
#  #  #  #  #
#############
