###############
#      *      #
# #####$##### #
# #    *    # #
# #.# #*# # # #
#   #* . *#   #
# # # #*# # # #
# #    *    # #
#  *###$##### #
#      *     @#
###############
