  ###############
  #    * # *    #
 ##  $ * @ * $  ##
## .##   #   ##. ##
# .** # ### # .*. #
# $ $ * .$. * $ $ #
#  *. #*###*# .*  #
# $ $ #  #  # $ $ #
# .*.#   #   #.*. #
## $#  $ # $  #$ ##
 ##  .  ###  .  ##
  ####### #######
