#################
#.      +      .#
# * *$* # *$* * #
#*** *  #  * *  #
# * *$* # *$* * #
#  . *  #  * .  #
# * *$**# *$* * #
#  * * ... * *  #
#** *$* * *$* * #
#  . * .$. * .  #
# * * * * * * * #
#  *$*$*$*$*$*  #
#** * * * * * * #
#.             .#
#################
