   #############
   #           #
 ### #### #### ###
 # $.#  # #  #.$ #
## * *  # #  * * ##
# * ##* @*  *## * #
# *  *   #   *  * #
#    #########    #
######       ######
