 ############
##. .$ $.   #
#.#$## ##.# #
# $   *   * #
#.#  * *  #.#
#$# * # * #$#
#  * *@* *  #
#$# * * * #$#
#.#  * *  #.#
# $   *   $ #
# # ## ##$#.#
#   .$ $. .##
############
