###################
#  #          #   #
#    # $.#.$#  *  #
# *##  # # * ### ##
## #  * * * *  #  #
#  # * * * * *  # #
# # * * * # * *   #
# $* * * ### # ## #
# . * * ### * * # #
# ## * ### * * *  #
# # * * # * * * ###
# #  * * * * * ##
#  #  * *.* *  #
## ### * # *  ##
#  *  # ## $ ##
#   #      @ #
##############
