   ##########
   #   .    ###
   #  ###   * #
   ##* * *### #
##### #$# ### #
#      @      #
# ### #$# #####
# ###* * *###
# *   ###   #
###    .    #
  ###########
