####  ############
#  ####          #
#....   $ $ $ $ $##
#.... ######$ $ $ #
##...#    @# $ $  #
 #...# $   #$ $ $ #
 #...#     # $ $  #
 #...# $   #$ $ $ #
 #...#     # $ $  #
 #...# $  ##$ $ $ #
 #...#    # $ $ $ #
 #...# $  # $ $ $ #
 #...#    # $ $ $ #
 #...# $  # $ $ $ #
 #.....** # $ $ $ #
 #   #    #      ##
 #################
