#####   #####
#   #####   #
# # $ # $ # #
#   * * *   #
## **. .** ##
 #  *   *  #
 #####@#####
 #  *   *  #
## **. .** ##
#   * * *   #
# # $ # $ # #
#   #####   #
#####   #####
