###############
#      *      #
# #####$##### #
# #    *    # #
# #.#$#*# # # #
#   #. . .#   #
# # #$#*# # # #
# #    *    # #
#  *###$##### #
#      *     @#
###############
