  ###############
  #    * # *    #
 ##  $ * @ * $  ##
## .##   #   ##. ##
# .** # ### # **. #
# $ $ * .*. * $ $ #
#  *. #*###*# .*  #
# $ $ #  #  # $ $ #
# .*.#   #   #.*. #
## $#  $ # $  #$ ##
 ##  .  ###  .  ##
  ####### #######
