####       #####
#  #########   ###
#....  $ # $ # $ #
#....# $ # $ # $ #
##.+.# $ # $ # $ #
 #...# $ # $ # $ #
##...# $ # $ # $ #
#  . # $   $     #
#  $ ##   ########
#      ####
#      #
#      #
########
