 ###########
## *      .##
#. # ** #   #
#  # $  ###*#
# ###*#*#   #
#   *   *$* #
# * # # # * #
# *$*   *   #
#   #*#*### #
#*###  $ #  #
#   # ** # .#
# +      * ##
############
