  #####
 ##   ## #####
##  $  ###  .#
#  ##*  #  *##
# ### # # # #
#*  #  *.*  #
# # # # # # #####
#  * *  #  * *  #
# # $ # # # $ # #
#  * *  #  * *  #
##### # # # # # #
    #  *.*  #  *#
    # # # # ### #
   ##*  #  *##  #
   #+  ###  $  ##
   ##### ##   ##
          #####
