#########
#.     .#
# * *$* #
# ** *  #
# * *$* #
#  . *  #
# * *$* #####
# ** * .   .#
# * *$* *** #
#  . * . *  #
# * * * * * #
#  *$*$*$*$ #
# * * * * * #
#@         .#
#############
