 #################
 #       #       #
 # $ $$$ # $$$ $ #
 # $ $   #   $ $ #
##.##*#*###*#*##.##
#  #..*. * .*..#  #
#  ##  . $ .  ##  #
# *######*######* #
#*  . . .@. . .  *#
# *######*######* #
#  ##  . $ .  ##  #
#  #..*. * .*..#  #
##.##*#*###*#*##.##
 # $ $   #   $ $ #
 # $ $$$ # $$$ $ #
 #       #       #
 #################
