######## ########
#      ###      #
# $#$ * # * $#$ #
#  * ## # ## *  #
###.*   #   *.###
 #.*.# *@* #.*.#
###.*   #   *.###
#  * ## # ## *  #
# $#$ * # * $#$ #
#      ###      #
######## ########
