   ###############
####  #          #
#  #    $ $ $ $ $##
#.... ######$ $ $ #
#....#    @# $ $  #
##...#$.$. #$ $ $ #
 #...#     # $ $  #
 #...#$.$. #$ $ $ #
 #...#     # $ $  #
 #...#$.$.##$ $ $ #
 #...#    # $ $ $ #
 #...#$.  # $ $ $ #
 #...#    # $ $ $ #
 #...#$.  # $ $ $ #
 #...     # $ $ $ #
 #   #    #      ##
 #################
