#########
#       ##
# #####  #
# # . ## #
# #$   # #
# #   $# #
# #* . # #
#  ** *# #
##  ***  #
 ##  *  ##
  ## @ ##
   #####
