  ##### #####
  #   # #   #
### # ### # ###
#    * # *    #
# $** *@* **. #
#    * # *    #
### # ### # ###
  #   # #   #
  ##### #####
