   #############
  ##     #     ##
###  ###   ###  ###
#   #   # #   #   #
# # # # # # # # # #
# $$*$....*..$*$$ #
### # # #.# # # ###
  #     # #     #
  #######@#######
  #     # #     #
### # # #.# # # ###
# $$$$..*....$$$$ #
# # # # # # # # # #
#   #   # #   #   #
###  ###   ###  ###
  ##     #     ##
   #############
