       #####
       #   #
######## $ ########
#    * # * # *    #
# . $#  *.*  #$ . #
###  # *   * #  ###
  #* #       # *#
  #  ####*####  #
  # *    *@   * #
  #  ####*####  #
  #* #       # *#
###  # *   * #  ###
# . $#  *.*  #$ . #
#    * # * # *    #
######## $ ########
       #   #
       #####
