 #############
##  #     #  ##
# * * * * * * #
#* * * * * * *#
#             #
#.#.#.# #.#.#.#
# $ $ $ $ $ $ #
#######.#######
# $ $ $ $ $ $ #
#.#.#.# #.#.#.#
#      $      #
#   #  #  #  @#
###############
