  ###############
###      #      ###
#   #$## # ## #   #
# $$ $   # $  $ $ #
#  #...*.**# ..#  #
####@## .#. ## ####
####.. #* .*...#  #
# $ $  $ #   $ $$ #
#   # ## # ##$#   #
###      #      ###
  ###############
