############
#     *    #
# * * * *  #
# ** * * * #
# * * * *  ##
#  * *$* * +#
# * * * *  ##
# ** * * * #
# * * * *  #
#  * * * * #
##         #
 ###########
