   #############
   #           #
 ### #### #### ###
 # $.#  # #  #.$ #
## * *  # #  * * ##
# * ##* @*  *## * #
# *  *   #   *  * #
#    #########    #
# *  *   #   *  * #
# * ##*  *  *## * #
## * *  # #  * * ##
 # $.#  # #  #.$ #
 ### #### #### ###
   #           #
   #############
