     ########
     #      #
     # #$$# #
     # $  $ #
    ## #.*# ##
    #  .  .  #
 #### ##.*## ####
 #     #..#     #
 # #$#$#..#$#$# #
 #       .      #
#########*########
#     #... #     #
# $ $    .   $ $ #
#########*########
# $ $    *   $ $ #
#     #..+ #     #
##################
