####         ####
#  ###########  #
#  #  #   #  #  #
#     # # #     #
##$#***. .***#$##
 #      *      #
 #######@#######
 #      *      #
##$#***. .***#$##
#     # # #     #
#  #  #   #  #  #
#  ###########  #
####         ####
