#####
# + #
# * #
# **########
# * *      #
# * ** #   #
# * # * ####
# * ** *#####
# * * * *   #
# # # # #   #
# $       ###
#   #######
#####
