 ###########
 #   #  #  #
 # $. $ #$ #
##### # #. #
#     # # ##
# $##.    #
##   .###$#
# .# ##.  ##
# $#   .#$ #
#  # ##    #
#### ## #####
   # $  @.$ #
   #  #.#   #
   ##########
