  #########
  #   #   #
  #   $ $ ##
  ##$####  #
###.*.. ## ##
#  *     *  #
#  *##@##*  #
#  *     *  #
## ## ..*.###
 #  ####$##
 ## $ $   #
  #   #   #
  #########
