    ###########
#####    .    #####
#   # #$# #$# #   #
# #$$$#. . .#$$$# #
#   # #.#.#.# #   #
##     $#.#$    ###
 ## # #.#.#.# # #
  #$$$#.*+..*$$$#
  # # #.#.#.# # ##
###    $#.#$     ##
#   # #.#.#.# #   #
# #$$$*. . .#$$$# #
#   # #$# #$# #   #
#####    .    #####
    ###########
