#####
# + #
# * #   #####
# **#####   #
# * * .   $ #
# * ** **   #
# # # * # ###
# $ #* ## #
#   # * # #
###   #   #
  ###   ###
    #####
