####  ############
#  ####          #
#....   $ $ $ $ $##
#.... ######$ $ $ #
##...#    @# $ $  #
 #...# $ $ #$ $ $ #
 #...#     # $ $  #
 #...# $ $ #$ $ $ #
 #...#     # $ $  #
 #...# $ $##$ $ $ #
 #...#    # $ $ $ #
 #...# $ $# $ $ $ #
 #...#    # $ $ $ #
 #...#    # $ $ $ #
 #........# $ $ $ #
 #   #    #      ##
 #################
