###############
#       #     #
#.####  @  #$ #
#    *** ***  #
#****  ***  *##
#    *** ***  #
#.####     #$ #
#       #     #
###############
