   #######
####  #  ####
#  # $$$ #  #
#     #     #
#  * .$. *  #
#*#*#$#$#*#*#
#  * .$. *  #
# #   #   # #
#    .+.    #
#############
