       #####
       #   #
######## $ ########
#    * # * # *    #
# . $# $*.*  #$ . #
###  # *   * #  ###
  #* #       # *#
  #  ####*####  #
  # **   +   ** #
  #  ####*####  #
  #* #       # *#
###  # * . * #  ###
# . $#  *.*$ #$ . #
#    * # * # *    #
######## $ ########
       #   #
       #####
