#############
#.    *    .#
# #.$ * $.# #
# .#.$.$.#. #
# $.$$$ $.$ #
#  $ #.#$$  #
#**.$.@.$.**#
#  $$#.# $  #
# $.$ $$$.$ #
# .#.$.$.#. #
# #.$ * $.# #
#.    *    .#
#############
