      ####
   ####  ##
   #    $ #
 ### # *  #
 #  * *  ##
 # # * # #
##  * *  #
#  * # ###
# +    #
##  ####
 ####
