#############
#  #  #  #  #
#    $$$    #
#  #  $  *  #
#*#######*#*#
#  *  #  *  #
# #  .+.  # #
# ..*#$#*.. #
# #  .*.  # #
#  *  #  *  #
#*#######*#*#
#  #  $  *  #
#    $$$    #
#  #  #  #  #
#############
