      ####
      #  #
      #  #
      #  #
####### #####
#     *     #
# $********+#
#     *    ##
##### * ####
   #  *  #
   #  *  #
   #  #  #
   #######
