   #############
   #           #
 ### #### #### ###
 # $.#  # #  #.$ #
## * *  # #  * * ##
# * ##* @$  *## * #
# *  *   #   *  * #
#  . ######### .. #
# *$ *   #   *  * #
# * ##*  $  *## * #
## * *  # #  * * ##
 # $.#  # #  #.$ #
 ### #### #### ###
   #           #
   #############
