#############
#  #  #  #  #
#    $$$    #
#  #  $  *  #
#*#######*#*#
#  * ##  *  #
# #  .+.  # #
#  .####*.  #
# #  ...  # #
#  * ##  *  #
#*#######*#*#
#  #  $  *  #
#    $$$    #
#  #  #  #  #
#############
