   #############
   #           #
 ### #### #### ###
 # $.#  # #  #.$ #
## * *  # #  * * ##
# * ##*  @  *## * #
# *  *  .$.  *  * #
#    ###$#$###    #
# *  *  .$.  *  * #
# * ##*     *## * #
## * *  # #  * * ##
 # $.#  # #  #.$ #
 ### #### #### ###
   #           #
   #############
