######### #########
#       ###       #
# #$$$$.....#$$$# #
# # # #.#.#.# # # #
#     $$#.#$$     #
### # #.#.#.# # # #
  #$$$#.*.*.$$$$# #
### # #.#.#.# # # #
#     $*#@#*$     #
# # # #.#.#.# # ###
# #$$$$.....#$$$#
# # # #.#.#.# # ###
#     $$#.#$$     #
# # # #.#.#.# # # #
# #$$$#.....$$$$# #
#       # *       #
###################
