 #########
##       ##
#  #####  #
# ##   ## #
# # $#. # #
# #     # #
# # .#$ # #
# #*   *# #
#  ** **  #
##  ***  ##
 ##  *  ##
  ## @ ##
   #####
