  ##### #####
###   # #   ###
# . $$###$$ . #
# # #. * .# # #
# # # #*# # # #
# # $  $  $ # #
# ###. + .### #
# ### ### ### #
#     # #     #
####### #######
