   #############
   #           #
####$ $ $ $ $ $###
#     #######    ##
# $$ $ $ $ * $ $$ #
#   ##.*.#.*.##   #
# $**..*.*.*..*.$ #
#   ##...*+**######
######.*.*.*.##   #
# $.*..*.*.*..**$ #
#   ##.*.#.*.##   #
# $$ $ $ $.* $ $$ #
##    ####**#     #
 ###$ $ $ $.$ $####
   #           #
   #############
