   #####   #####
  ##   ## ##   ##
 ##  $  ###  *  ##
 #  *#*  #  *#*  #
## * # * # * # * ##
# *  #  *.*  #  * #
#  * # * # * # *  #
##  * *  #  * *  ##
 # # $ #.#.# $ # #
##  * *  #  * *  ##
#  * # * # * # *  #
# *  #  *.*  #  * #
## * # * # * # * ##
 #  *#*  #  *#*  #
 ##  *  ###  $  ##
  ## @ ## ##   ##
   #####   #####
