  ######## ######
  #    * ###    #
  #  $ * # * $  ##
 #####   #   ##. ##
##.#. # ### # .*  #
# $ $ *  @  * $ $ #
#  *. # ### # .#.##
## .##   #   #####
 ##  $ * # * $  #
  #    ### *    #
  ###### ########
