####           ####
#  #############  #
#  #  #  #  #  #  #
#     #  #  #     #
##$#****. .****#$##
 #       *       #
 ########@########
 #       *       #
##$#****. .****#$##
#     #  #  #     #
#  #  #  #  #  #  #
#  #############  #
####           ####
