#####        ####
#   ##########  #
#            *  #
##*### #####$#  #
 # $ $ #..   # ##
 # # # ### #$# #
 # #    #      #
 # #.## #  ### #
 # #.##* *##.# #
 # ###  #  #.# #
 #      #    # #
 # #$# ### # # #
 # #   .+# $ $ #
 # #$##### ###*##
 # *            #
 ############   #
            #####
