  ###############
  #    * # *    #
 ##  $ * + * $  ##
## .##   #   ##. ##
# .** # ### # **. #
# $ $ * .$. * $ $ #
#  *. #*###*# .*  #
# $ $ #  #  # $ $ #
# .*.#   #   #.*. #
## $#  $ # $  #$ ##
 ##  .  ###  .  ##
  ####### #######
