##############
#  $.  #  *  #
#  $.  #  *$ #
# *$***.*. . #
#  $.  #  *$ #
#* $.  #  *  #
#@############
#* $.  #  *  #
#  $.  #  *$ #
# *$***.*. . #
#  $.  #  *$ #
#  $.  #  *  #
##############
