 ###########
##      #@ #
#  $ $* #$ #
#  ###..#  #
# $#..*.#$ #
#  #..*.#  #
# $#..*.#$ #
#  #..*.#  #
# $##$###$ #
#  ## $ #  #
# $$     $ #
#  # ###   #
###### #####
