   #####
  ##   ##
 ##  $  ##
 #  *#*  #
## * # * ##
# *  #  * #
#  * # *  #
##  * *  ##
 # #.$.# #
##  * *  ##
#  * # *  #
# *  #  * #
## * # * ##
 #  *#*  #
 ##  *  ##
  ## @ ##
   #####
