#############
#.    #    .#
# #.$ * $.# #
# .#.$ $.#. #
# $.$ $ $.$ #
#  $ #.# $  #
##* $.@.$ *##
#  $ #.# $  #
# $.$ $ $.$ #
# .#.$ $.#. #
# #.$ * $.# #
#.    #    .#
#############
