  #####   #####
###   #####   ###
# $ # $ # $ # $ #
# *   * * *   * #
#.## **. .** ##.#
#     #   *     #
########@########
#     #   #     #
#.## **. .** ##.#
# *   * * *   * #
# $ # $ # $ # $ #
###   #####   ###
  #####   #####
