####
#  #########
#  $  *  $ ##
#  * *** #  #
# # . * .## #
# ### # ### #
# ##. @ . # #
#  # *#* *  #
## $  *  $  #
 #########  #
         ####
