####      #####
#  #   ####.  #####
# $#####  # # ##  #
#  ##  #    # ##$ #
# $#        #  #  #
#  #   ### ## $#$ #
# $## ##....#  #  #
#   #  #....# $#$ #
#   #  #....#  #  #
# $ #  #....# $$$ #
##  #####.###     #
 #$ $ $ #.     #$ #
 #  $ $ #..@ ###  #
 #$          # $$ #
 #  #######  #    #
 ####     #########
