####       #####
#  #########   ###
#....  $ # $ # $ #
#....# $ # $ # $ #
##.+.# $ # $ # $ #
 #...# $ # $ # $ #
##...# $ # $ # $ #
#    # $   $     #
#    ##   ########
#     #####
#     #
#     #
#######
