  ###########
 ##  .*.*.  ##
 #  # .$. #  #
 # $##.#.##$ #
## $ #.#.# $ ##
#  # $ # $ #  #
# $$  $#$  $$ #
#  # $ # $ #  #
## $ #.#.# $ ##
 # $##.#.##$ #
 #  # .$. #  #
 ##  ..+..  ##
  ###########
