 ###########
##    #    ##
# .*.$$$.*. #
# *# .*. #* #
# .  $$$  . #
# $.$. .$.$ #
##$*$ # $*$##
# $.$. .$.$ #
# .  $$$  . #
# *# .*. #* #
# .*.$$$.*+ #
##    #    ##
 ###########
