  #####
### @ ###
#   .   #
# * * * #
#  $*$  #
##**.**##
#   *   #
# * * * #
#   #   #
#########
