    ########
   ##. .$  ##
  ##.$.$ $. ##
 ##. .$.$ $  ##
##.$.$.$.$.$. ##
#. .$.$.$.$ $  #
#$.$.$.$.$.$ $ #
# $.$.$.$.$.$. #
# .$.$.$.$.$.$ #
# $ $.$.$.$.$.$#
#  $ $.$.$.$. .#
## .$.$.$.$.$.##
 ##  $ $.$. .##
  ## .$ $.$.##
   ##  $. +##
    ########
