###########
# .... #  ##
# .##.$#$  #
# *##. # $ #
# . $.$#$  #
# $##.     #
#  ##.$#####
# $ #. #   #
# @ #.$# $ #
##  #.   $ #
#.###.$##$##
#......$ $ #
#.$  #   $ #
# $$$#$  $ #
#    #     #
############
