###########
#. . * . .#
# * $ $ * #
#. * * * .#
# $ $ $ $ #
#* * @ * *#
# $ $ $ $ #
#. * * * .#
# * $ $ * #
#. . * . .#
###########
