   #######
####  *  ####
# *   .   * #
# ##$#.#$## #
# ##     ##@#
# ##$#.#$## #
# *   .   * #
# ##  *  ## #
#  #######  #
##         ##
 ###########
