 ###########
##    #    ##
# .**   **. #
# *# *** #* #
# *   $   * #
#  * .$. *  #
## *$$*$$* ##
#  * .$. *  #
# *   $   * #
# *# *** #* #
# .** @ **. #
##    #    ##
 ###########
