 ###########
##    #    ##
# .**   **. #
# *# ### #* #
# *   $   * #
#  * .$. *  #
## #$$#$$# ##
#  * .$. *  #
# #   $   # #
# ## *#* ## #
# .** @ **. #
##    #    ##
 ###########
