 ###########
##    #    ##
# .**   **. #
# *# *** #* #
# *   *   * #
#  *  $  *  #
## **$#$** ##
#  *  $  *  #
# *   *   * #
# *# *** #* #
# .** @ **. #
##    #    ##
 ###########
