  ############
###          #
# $**####### #
# #   *  * # #
# #  *  *  * #
# # #  #  ## #
# #*  ## * # #
# *  ####  # #
# # * ##  *# #
# #*  #  * # #
# #  *  #  # #
# ##*####**+ #
#            #
##############
