 ###########
##    #    ##
# .**   **. #
# *# *#* #* #
# *   $   * #
#  * .$. *  #
## #$$#$$# ##
#  # .$. #  #
# *   $   * #
# *# *#* #* #
# .## @ ##. #
##    #    ##
 ###########
