  #######
  # +   #
  # # # #
  # #   #
###*$*###
#   *   #
# # # # #
#   #   #
#########
