 #######
 #     #
## #+# ##
#  * *  #
# * * * #
# * $ * #
# * $ * #
# * * * #
#  * *  #
####.####
   ###
