 ############
##          #
# + *** *** ##
# *** *** *  #
#         ** #
# #######* * #
#         ** #
# *** *** *  #
# $ *** *** ##
##          #
 ############
