###########
#    + $  #
# ##$$$*# #
# *. # .# #
# $ ... $ #
# $#.#.#$ #
# $ ... $ #
# #. # .* #
# #*$$$## #
#         #
###########
