 ####### #######
##     ###     ##
#  ***  #  ***  #
# * $ * # * $ * #
# * # *   * # * #
# * .@* # * . * #
#  ***  #  ***  #
##     ###     ##
 ####### #######
