 ####### #######
##     ###     ##
#  ***  #  ***  #
# * $ * # * $ * #
# * # *   * # * #
# * .@* # * . * #
#  ***  #  ***  #
##     ###     ##
 ####### ### ###
##     ###     ##
#  ***  #  ***  #
# * $ * # * $ * #
# * # *   * # * #
# * . * # * . * #
#  ***  #  ***  #
##     ###     ##
 ####### #######
