###################
#  # .#.....#. #  #
# $#$. ..... .$#$ #
#  # .  .#.  . #  #
# $  #   #   #  $ #
# # $  # * #  $ # #
#  $ $#.*$*.#$ $  #
#   # .##+##. #   #
# $$#$. . . .$#$$ #
#   # $# $ #$ #   #
# $$#$.  #  .$#$$ #
#     #  #  #     #
# $####$###$####$ #
# $    $ $ $    $ #
#  #.. ..#.. ..#  #
###################
