###################
#                 #
# .$* * * * * * * #
#  # * * * * * *  #
# * * * * * * * * #
#  # * * * * * #  #
##### * * * * * * #
    ## * *@* * *  #
     ## * * * * * #
      ## * * * #  #
       ## * * * * #
      ## * * * *  #
####### * * * * * #
#  * * * * * * #  #
#                 #
###################
