###########
#.........#
#.$$$$$$$.#
#.$     $.#
#.$ $$$ $.#
#.$ $@$ $.#
#.$ $$$ $.#
#.$     $.#
#.$$$$$$$.#
#.........#
###########
