###########
#.. ... ..#
#.$$$$$$$.#
# $     $ #
#.$ *** $.#
#.$ *@* $.#
#.$ *** $.#
# $     $ #
#.$$$$$$$.#
#.. ... ..#
###########
