###########
#         #
# $**.**$ #
# * #.# ###
# *  @  #
# * #.# ###
# $**.**$ #
#         #
###########
