###########
#      *  #
#  * * * *#
# * * * *@#
#  * * * *#
# * * * * #
#  * ######
# * *#
#  * #
# *$.#
#    #
######
