     #####
  ####   #
 ##  .$@##
##  *$ ##
#  .$ ##
# .*  #
#  .$ ##
## $.$ ##
 ##  .  ##
  ####   #
     #####
