  #######
 ##     ###
##.$.$.$. #
# $.$.$.$ #
# $.$+$.$ #
# .$.$.$.##
##      ##
 ########
