#################
# . . . * . . . #
# * * * * * * * #
# * * * * * * * #
# * * * * * * * #
# * * * * * * * #
# * * * * * * * #
# * * * * * * * #
#  * * *#* * *  #
##  * * * * *  ##
 ##  * *#* *  ##
  ##  * * *  ##
   ##  * *  ##
#####  *+*  #####
#     * # *     #
# $*$*$*$*$*$*$ #
#               #
#################
