#################
# . . . * . . . #
# * * * * * * * #
# * * * * * * * #
# * * * * * * * #
# * * * * * * * #
# * * * * * * * #
# * * * * * * * #
#  * * *#* * *  #
##  * * * * *  ##
 ##  * *#* *  ##
  ##  * * *  ##
   ##  * *  ##
#####  *.*  #####
#     * # *     #
# $*$*$*$*$*$*$ #
#       @       #
#################
