 #####################
##                   ##
# $**#**#**#** **#**  #
# *   * *  *  *  *  * #
# *  *  **  * **  * * #
# # *  *# *  *# *  *# #
# **  * *  *  *  *  * #
# *  *  *   * *   * * #
# #**#** **#**#**#**# #
# * *   *   * *  *  * #
# *  *  *  *  **  * * #
# #*  * * *  ** *  *# #
# * *  ***  * *  *  * #
# *  *  *  *  *   * * #
# #**#**#**#** **#**# #
# * *   * *   *   * * #
# *  *  *  *  *  *  * #
# #*  * #*  * # *  *# #
# * *  ** *  ***  * * #
# *  *  *  *  *  *  * #
#  **#** **#**#**#**+ #
##                   ##
 #####################
