       #####
      ## . ##
     ##  *  ##
     #  *$*  #
     #.* # *.#
  ####  *$*  ####
 ## . #  *  # . ##
##  *  # * #  *  ##
#  * *   $   * *  #
#.*$#$**$#$**$#$*.#
#  * *   $   * *  #
##  *  # * #  *  ##
 ## . #  *  # . ##
  ####  *$*  ####
     #.* # *.#
     #  *$*  #
     ##  *  ##
      ## + ##
       #####
