   #######
  ##     ##
 ## $.$.$ ##
## $.$.$.$ ##
# $.$.$.$.$ #
# .$.$.$.$. #
# $... ...$@#
# .$.$.$.$. #
# $.$.$.$.$ #
## $.$.$.$ ##
 ## $.$.$ ##
  ##     ##
   #######
