#################
#.  *  .#.  *  .#
# .$*$  #  $*$. #
# $ . $ # $ . $ #
#$*.#.*.*.*.#.*$#
#   # $ * $ #   #
##### $$*$$ #####
    #.  *  +#
    #########
