##################
#                ##
# * * # #$# # * # #
#  * * * * * * *  #
# # * * * * * * * #
#  * * * * * * *  #
# # * ### ### * * #
#  * *##  .##* *  #
# * * ## +### * * #
#  * *##  .##* *  #
# # * ### ### * * #
#  * * * * * * *  #
# # * * * * * * * #
#  * * * * * * *  #
# $ * # *$* # * # #
##                #
 ##################
