   #####
  ##   ##
 ## $.$ ##
## $.$.$ ##
# $.$.$.$ #
# .$.$.$. #
# . .*. .@#
# .$.$.$. #
# $.$.$.$ #
## $.$.$ ##
 ## $.$ ##
  ##   ##
   #####
