       #####
      ## . ##
     ##  *  ##
     #  *.*  #
     # *$#$* #
  ####  *.*  ####
 ##   *  *  *   ##
##  *  # * #  *  ##
#  *$*   $   *$*  #
#.*.#.**$#$**.#.*.#
#  *$*   $   *$*  #
##  *  # * #  *  ##
 ##   *  *  *   ##
  ####  *.*  ####
     # *$#$* #
     #  *.*  #
     ##  *  ##
      ## + ##
       #####
