##################
#                ##
# * * * *$* * * * #
#  * * * * * * *  #
# * * * * * * * * #
#  * * * * * * *  #
# * * *## ##* * * #
#  * * #  .# * *  #
# * * *# + #* * * #
#  * * #  .# * *  #
# * * *## ##* * * #
#  * * * * * * *  #
# * * * * * * * * #
#  * * * * * * *  #
# $ * * *$* * * * #
##                #
 ##################
