 #################
##               ##
# ..*.*.*.*.*.*.. #
# .# # # # # # #. #
# * $ $ $ $ $ $ * #
# .# $ $ * $ $ #. #
# * $ * * * * $ * #
# .# $ * * * $ #. #
# * $ * # # * $ * #
# .# * * * * * #. #
# * $ * # # * $ * #
# .# $ * * * $ #. #
# * $ * * * * $ * #
# .# $ $ * $ $ #. #
# * $ $ $ $ $ $ * #
# .@ # # # # # #. #
# ..*.*.*.*.*.*.. #
##               ##
 #################
