##################
#                ##
# * * * *$* * * * #
#  * * * * * * *  #
# * * * * * * * * #
#  * * * * * * *  #
# * * *## ##* * * #
#  * * #. .# * *  #
# * * *# . #* * * #
#  * * # $.# * *  #
# * * *##@##* * * #
#  * * * * * * *  #
# * * * * * * * * #
#  * * * * * * *  #
# $ * * *$* * * * #
##                #
 ##################
