#############
#          @#
# ###****** #
# # #     * #
# ###...##* #
# #       * #
# #$$$#$$$* #
# *       * #
#####...##* #
    #     * #
    #****** #
    #       #
    #########
