 ###############
##             ##
# $***********  #
# *   * *  *  * #
# *  *  **  * * #
# * *  ** *  ** #
# **  * *  *  * #
# *  *  *   * * #
# ****** ****** #
# * *   *   * * #
# *  *  *  *  * #
# **  * * *  ** #
# * *  ***  * * #
# *  *  *  *  * #
#  ***********+ #
##              #
 ################
