 #################
 #.#.#.#.#.#.#.#.#
##*# # # # # # #*##
# . $ $ $ $ $ $ . #
# *# $ * * * $ #* #
# . $ * # # * $ . #
# *# $ * * * $ #* #
# . $ * # # * $ . #
# *# * * * * * #* #
# . $ * # # * $ . #
# *# $ * * * $ #* #
# . $ * * * * $ . #
# *# $ * * * $ #* #
# . $ $ $ $ $ $ . #
# *@ # # # # # #* #
# .*.*.*.*.*.*.*. #
##               ##
 #################
