   #######
  ##     ##
 ##  *$*  ##
##  * $ *  ##
#  *  #  *  #
##  * * *  ##
 ##  *.*  ##
  ###.#.###
 ##  *.*  ##
##  * * *  ##
#  *  #  *  #
##  * $ *  ##
 ##  *$*  ##
  ##  @  ##
   #######
