    ###########
   ##         ##
  ## $.$.$.$.$ ##
 ## $.$.$.$.$.$ ##
## $.$.$.$.$.$.$ ##
# $.$.$.$.$.$.$.$ #
# .$.$.$.$.$.$.$. #
# $.$.$.$.$.$.$.$ #
# . . . .*+ . . . #
# $.$.$.$.$.$.$.$ #
# .$.$.$.$.$.$.$. #
# $.$.$.$.$.$.$.$ #
## $.$.$.$.$.$.$ ##
 ## $.$.$.$.$.$ ##
  ## $.$.$.$.$ ##
   ##         ##
    ###########
