       #####
      ## . ##
     ##  *  ##
     #  * *  #
     # **# # #
  ####  * *  ####
 ##   #  *  #   ##
##  #  # # #  *  ##
#  * *   $   ***  #
#.* # *#$#$#* # *.#
#  ***   $   * *  #
##  *  # ###  #  ##
 ##   #  *  #   ##
  ####  * *  ####
     # # #** #
     #  * *  #
     ##  *  ##
      ## + ##
       #####
