##################
#                ##
# * * # *$* # * # #
#  * * * * * * *  #
# # * * * * * * * #
#  * * * * * * *  #
# # * *## ##* * * #
#  * * #  .# * *  #
# * * *# + ## * * #
#  * * #  .# * *  #
# # * *## ##* * * #
#  * * * * * * *  #
# # * * * * * * * #
#  * * * * * * *  #
# $ * # *$* # * # #
##                #
 ##################
