  ###############
###             #
# $**#####*###  #
# *   * #  *  * #
# *  *  ##  * * #
# # *  ** *  ## #
# #*  * *  *  # #
# #  *  *   # # #
# ###*** **#### #
# # *   #   # # #
# #  *  #  *  # #
# #*  * # *  ## #
# * *  ###  * * #
# *  *  #  *  * #
#  ##**#######+ #
#               #
#################
