 #########
##       ##
# .*.*.*. #
# * $ $## #
# .$#$ $. #
# * $@$ * #
# .$ $#$. #
# ##$ $ * #
# .*.*.*. #
##       ##
 #########
