#########
#   *   #
# #$*$# #
# .* *. #
##  *  ##
 #  *  #
 #@*#* #
 #  *  #
##  *  ##
# .* *. #
# #$*$# #
#   *   #
#########
