 ########
##      ##
# $***#  ##
# *   ##  ##
# *  *  #  #
# * * * ## #
# ##   * * #
#  #  *  * #
##  ##   * #
 ##  #***+ #
  ##      ##
   ########
