########   ########
#      #####  *   #
# $*** * # . ***. #
#   #    # $  #   #
##  #  * # *  #  ##
 #*####* @ *####*#
##  #  * # *  #  ##
#   #    # $  #   #
# $*** * # . ***. #
#      #####  *   #
########   ########
