    #####
 ####   ####
 #.## $ * .#
 # ##   ####
##*##*#*#####
#   * @ *   #
# $ # # # $ #
#   *   *   #
#####*#*##*##
 ####   ## #
 #. * $ ##.#
 ####   ####
    #####
