      #### ####
####### .###  #
# $     $$   $#
#   $ ## ###  #
## ##   $  #$ #
 # #  ##*#    #
##$# #....# # ##
#.$ $*....# #  #
#  # #....$$ $.#
## # #....# #$##
 #    #*##  # #
 # $#  $   ## ##
 #  ### ## #   #
 #$   $$     $@#
 #  ###. #######
 #### ####
