 ###########
##   .@.   #
#  $*$*$*$ #
#  . * * . #
#####   ####
    # # #
    #   #
    #####
