  ######
  #. $ ##
###.#.* #
# .$ $. #
# * $ * #
# .$#$. #
# * $ * #
# .$@$. #
# * $ * #
# .$#$. #
# * $ * #
# .$ $. #
# *.#.###
## $ .#
 ######
