########
#      ###
# * *#   ##
# *# ###  #
# *  $ ## #
#  # . #  #
# *** *** #
#  # *    #
# *  #  * #
#    * #  #
# *** *** #
#  # . #  #
# ## $  * #
#  ### #* #
##   #* * #
 ### @    #
   ########
