#######
#     #######
#.*****     #
# #   * #$# ######
#     #  *  #    #
####### #$# #    ##
      #     *****+#
      #######     #
            #######
