   ###########
   #         #
   # * *** * #
#### *# # #* ####
#    *  $  *    #
# *** # . # *** #
#  # *** *** #  #
# *     *     * #
# ##$. ### .$## #
#  #    *    #  #
## # *** *** # ##
 # #* # . # *# #
 #   *  $  *   #
 ### ####### ###
   #    @    #
   ###########
