 ##############
 #           .#
##*$******$##.#
#   #   #   #.#
#   #  .$.  * #
###$ *#$#$$##@#
#   #  .$.  * #
#   #   #   #.#
##*$******$##.#
 #           .#
 ##############
