 #######
## * * ##
# *.*.* #
# .$ $. #
# * $ * #
# .$#$. #
# * $ * #
# .$@$. #
# * $ * #
# .$#$. #
# * $ * #
# .$ $. #
# *.*.* #
## * * ##
 #######
