     #####
######   ######
#.   $ * $   .#
##****   ****##
 #   *****   #
 #     #     #
 #***********#
 #@          #
 #############
