    ###########
    #         #
    # * *** * #
##### *# # #* #####
#     *  $  *     #
# ***  # . #  *** #
#  # #*** ***# #  #
# *      *      * #
# *#$.* ### *.$#* #
# *      *      * #
#  # #*** ***# #  #
# ***  # . #  *** #
#     *  $  *     #
##### *# # #* #####
    # * *** * #
    #    @    #
    ###########
