  #######
  #  *  #
 ## *** ##
##   *   ##
#  * * *  #
#@*.***.* #
#  * * *  #
##  $.$  ##
 ## .*. ##
  ###.###
  # $.$ #
  # $.$ #
  # $.$ #
  # $.$ #
  #     #
  #######
