   ########
   #   #  #
   # $. $ #
####### * ####
#       # #  #
# $*###.# #$ #
##   .### #. #
# .# ###.   ##
# $# #+###*$ #
#  # #       #
#### * #######
   # $ .$ #
   #  #   #
   ########
