 ##############
 #           .#
##$*******$##.#
#   #   #   #.#
#   #  .$.  * #
##$* *#$#$$##@#
#   #  .$.  * #
#   #   #   #.#
##$*******$##.#
 #           .#
 ##############
