     #######
    ##     ###
    #  #*#   #
 #### ## ### #
##    *  $ # #####
#  #*  # . #     #
# ## #*** ###### ##
# *      *     #  #
# ##$.  ###  .$## #
#  #     *      * #
## ###### ***# ## #
 #     # . #  *#  #
 ##### # $  *    ##
     # ### ## ####
     #   #*#  #
     ### @   ##
       #######
