#### ####
#  ###  #
# **.** #
# * # * #
# *   * #
# *   * #
# ##*## #
# *   * #
# *   * #
# # # # #
# #*$*# #
#   @   #
#########
