  ####
  #  ####
### $.$ ###
#  . * .  #
#  * # *  #
## *$*$* ##
 #   . ###
 ####@ #
    ####
