   #####
####   #
#    $ #
#   #$###
## ## @ #
# ..#   #
# ..$$ ##
##  #  #
 #######
