 #####
 #  @##
 # $$ #
 #$ # #
## ...#
#  # ##
#    #
###  #
  ####
