#######
#...  ###
#@##$$  #
# $     #
#.# ## ##
# $ #  #
###   ##
  #####
