 ####
 #  ####
 # ..  #
 # .*  #
##$.* ##
# $.* #
#@$#$ #
# $   #
####  #
   ####
