  ####
  #  ###
### $$ #
#    # #
# #....#
#  $$  #
##..#**#
 #$$  @#
 #   ###
 #####  
