  #######
  #  #  #
  #     #
  #..#$$#
###     ###
# ...#$$$ #
#         #
###..#$$###
  #  @  #
  #######
