##############
#            #
# $**. *#.**$##
# *  $@$ * #. #
# *$*.#* *.*$ #
# * $.#. * .$ #
##$..$#*#.$$. #
 #           ##
 ###  ###  ###
   #### ####
