       #####
########   #
#          #
# # $*$## ##
#.##* * # #
#    *  # ##
# *@ #  #  #
## * ## *  #
 ##  .  #  #
  ##########
