  #####
### @ ###
#  *#*  #
# #. .# #
# $   $ #
# #*#*# #
# $   $ #
# #. .# #
# $. .$ #
###   ###
  #####
