  ####
  #  ###
  # $  ######
  #  #$##   #
  ##. . . $ #
 ### #*# # ##
 # $.*@*.$ #
## # #.# ###
# $ .   .##
#   ##$#  #
######  $ #
     ###  #
       ####
