 #####
 #   ###
 #  $  #
###.$. #
#  $.$###
# #.$.  #
# #$@$# #
#  .$.# #
###$.$  #
 # .$.###
 #  .  #
 ###   #
   ##### 
