 #####
 #   ####
 #$  $  #
## @**  #
#  **. ##
# $*.. #
###   ##
  #####
