 ####
##@ #####
# $$$   #
# # # # #
# ...   #
####   ##
   #####
