    ####
 ####@ #
 # $   #
## ###$##
#.  $  .#
#   #   #
### # ###
 #.   #
 #   ##
 #####
