 ########
 #  #   #
##$ $$# ###
#.*.#@$   #
#...#$#   #
#.#*$  # ##
# #    # ##
#  ##     #
##    #   #
 ##########
