##### ####
#   ###  #
#    $   #
## ####  #
 #$#..#$##
 # #.....#
 #   ..# ###
 # #$## $  #
 #  $@$$   #
## ##$#  ###
#       ##
#   #####
#####
