  ####
 ##  ####
 #  $   #
##.$#*  #
# .$@* ##
# .... #
# $ $ $#
#####  #
    ####
