 ####      
 #  #####  
##* *   ## 
# $ #  * ##
#   ##*  .#
### #  *# #
 #      # #
 #  # ### ##
 #   *@##  #
 ###  * *  #
   ##   #  #
    ########
