 #######
 # .   #
##$#*# ##
#  *    #
#   @*  #
## #*#$##
 #   . #
 #######
