 ########
 #  .   #
 #.$..$ #
##$$@$$##
# $..$.#
#   .  #
########
