#########
#   .   #
#   # $ #
# *###.$#
#  $@$  #
#* .#.$.#
# $###  #
#   .   #
#########
