 #########
##   #   #
#     *  #
# #* * *##
# $ # *  #
#  *@*#. #
####* *  #
   #   ###
   #####  
