   #######
 ###  .  ###
## * #$#$* ##
#  *  *  .  #
# #$#@*$# # #
#  .  #  .  #
##   ###   ##
 ##### #####
