 #####
 # @ ##
 # #  #
##$.$ #
# *.* #
# $.$###
#  # . ##
##  .** #
 #$# .  #
 #  $#  #
 ###   ##
   #####
