####      ####
#  ########  #
# $ # .. # $ #
#  $$$..$$$  #
##    **     #
 #@ #....#  ##
 ############
