    #######
   ##     #
  ## $##  #
 ## .. .  #
 # $$##$  #
##$.*@*.$##
#   ##$  #
#  . ..###
#  ##$ #
#     ##
#######
