  #########
  #   #  @#
 ##  .$.# #
 #  ##  $ #
##  .$*#$##
#  #$#   #
#  . .# ##
####    #
   ######
