  ##########
  #   ##   #
###   . .# #
#  # ##  $ #
# $  .**#$##
#   # #   #
##  *$.# ##
 ####   @#
    ######
