   #####
####   #
#  #.#$###
#   . $  #
#....#$# #
###$# $  #
 # $  @ ##
 #   ####
 #####
