   #####
  ##   #
 ##  # #
 #.$*  #
##$.$* #
# *@.$ #
#  *$. #
# # .###
#   ##
#####
