      ####
#######  #
#  $     #
#  $#    ####
###  # ###  #
  # $@$  $$ #
  # $## ##  #
  #   .... ##
  ####...  #
     #######
