   #####
####   #
# $  #.##
#   *   #
##.#  $ #
 # @ ####
 #####
