    ##### #####
  ###   ###   #
  #@$ #  $    #
  #$#.######$##
### ....#  # #
#   . . #  # #
# # ....#  # #
# #    ##### #
# $ ##$#   # #
###$$  #$  # ##
  #           #
  ##  #  $# $ #
   #####  ##  #
       ########
