 ############
##       @ .#
# *$* *$* * #
# $. .$.$.  #
# * * * *#* #
# $.$.$.$.  #
# * * # * * #
#  .$.$.$.$ #
# *#* * * * #
#  .$.$. .$ #
# * *$* *$* #
#.          #
#############
