#############
#@          #
#  * * * *  #
# * * * * * #
#  * *$* *  #
# * * . * * #
#  * * * *  #
# * * * * * #
#           #
#############
