      ###############
     ##   #        @#
    ## .$.$.$.$.$$  #
   ## .$.$.$.$.$.$ ##
  ## .$.$.$.$.$.$ ##
 ## .$.$.$.$.$.$ ##
## .$.$.$.$.$.$ ##
# .$.$.$.$.$.$ ##
#.            ##
###############
