 ###########
##         ##
#  $.$ $.$  #
# $*$.*.$*$ #
# .$.*.*.$. #
# $.*.$.*.$ #
#  *.$@$.*  #
# $.*.$.*.$ #
# .$.*.*.$. #
# $*$.*.$*$ #
#  $.$ $.$  #
##         ##
 ###########
