 ###########
##  @      ##
#  $.$.$.$  #
# $.$.$.$.$ #
##.$.$.$.$. #
# $.$.#.$.$ #
# .$.###.$. #
# $.$.#.$.$ #
# .$.$.$.$. #
# $.$.$.$.$ #
#  $.$.$.$  #
##      #  ##
 ###########
