#############
#@          #
# #.$.$.$.# #
# .$.$.$.$. #
# $.$.$.$.$ #
# .$.$.$.$. #
# $.$.$.$.$ #
# #$.$.$.$# #
#           #
#############
