#############
#          .#
# $$$$$$$$$ #
# $  . .  $ #
# * *$*$* * #
#.$.$. .$.$.#
# * * + * * #
#.$.$. .$.$.#
# * *$*$* * #
#.$. . . .$.#
# .$*$*$*$* #
#. . . . . .#
#############
