     #####
   ###@  ###
  ##   $   ##
 ##.*.*.*.*.##
## . $ $ $ . ##
# $.$.* *.$.$ #
#  * * $ * *  #
# $.$ $ $ $.$ #
#  * * $ * *  #
# $.$.* *.$.$ #
## . $ $ $ . ##
 ##.*.*.*.*.##
  ##   $   ##
   ###   ###
     #####
