#############
#.*.*.*.*.*.#
#*.*.*.*.*.*#
#.$.$ $ $.$.#
#$ $ $ $ $ $#
# $ $ @ $ $ #
#$ $ $ $ $ $#
# $ $ $ $ $ #
#$ $ $ $ $ $#
#.*.*.*.*.*.#
#*.*.*.*.*.*#
#.*.*.*.*.*.#
#############
