 ############
##          #
# *$.#.#.$* #
# $.$.$.$.$ #
# .#.$.$.#. #
# $.$ $ $.$ #
# * .$@$. * #
# $.$ $ $.$ #
# .#.$.$.#. #
# $.$.$.$.$ #
# *$.#.#.$* #
#           #
#############
