         #########
   #######       #
#### . . .$.$.$. #
# .$.$.$.$.$.$.$ #
# $.$.$.$ $*$.  ##
# .$.$*$.$.$.$ ##
## .$.$@$.$.  ##
 # $.$.$.$. ###
 ##  .$.$.$ #
  ##.$.$.$ ##
   #  $.  ##
   ##   ###
    #####
