     #####
   ###  @###
  ##  .$.  ##
 ## $ $.$ $ ##
##  .$. .$.  ##
# $.$.$.$.$.$ #
# .$. .$. .$. #
#.$ $ $*$ $ $.#
# .$. .$. .$. #
# $.$.$.$.$.$ #
##  .$. .$.  ##
 ## $ $.$ $ ##
  ##  .$.  ##
   ###   ###
     #####
