#############
#  @   #    #
# # $ * $ # #
#. * . * . $#
# * # * # * #
#$ . * . $ .#
# # * $ * # #
#. $ . * . $#
# * # * # * #
#$ . * . * .#
# # $ $ $ # #
#    #      #
#############
