     #####
   ###...###
  ##.*.$.*.##
 ##.* $ $ *.##
##.* $ $ $ *.##
#.* $#$ $#$ *.#
#* $ $ * $ $ *#
#.$ # .@. # $.#
#* $ $ * $ $ *#
#.* $#$ $#$ *.#
##.* $ $ $ *.##
 ##.* $ $ *.##
  ##.*.$.*.##
   ###...###
     #####
