 ############
##          #
# $.$.$.$.$ #
# .$.$.$.$. #
# $.$.$.$.$ #
# .$.$+$.$. #
# $.$.$.$.$ #
# .$.$.$.$. #
#          ##
############
