        #####
#########   #
# $.$.$.$.$ #
# .$.$.$.$. #
# $.$.$.$.$ #
# .$.$.$.$. #
# $.$.$.$.$ #
# .$.$.$.$. #
#          @#
#############
