#########
#   *   #
# $.$.$ #
# .$.$. #
# $.$.$##
# .$.$. #
# $ * $ #
# .$.$. #
# $.$.$ #
# .$.$. #
# $ * $ #
# .$.$. #
# $.$.$ #
# .$.$. #
# $ # $ #
#.$.$.$.#
#$.$.$.$#
#.$.$.$.#
#$.$.$.$#
#.@. . .#
#########
