 #############
##        #  ##
# $.$. # .$.  #
#  $.$. # .$  #
##$. #$.$.$.$ #
#  $##.@. #$  #
# $. # .$# .$##
#  $. # .$.$  #
#  .$. #$.$.$ #
##  #        ##
 #############
