#############
#@          #
# $.$.$.$.$ #
# .$.$.$.$. #
# $.$.$.$.$ #
# .$.$*$.$. #
# $.$.$.$.$ #
# .$.$.$.$. #
#          .#
#############
