#####
#   ####
# #$   ###
# #.*$*  #
# # .* # #
#  . $.#@#
###  $ # #
  ####   #
     #####
