 #####
 #   #####
 #     $@#
 ## ##.#*###
### # $  $ #
# $ .$. .# #
#   $ ##$# #
###.#.  .  #
  #   ######
  #####
