  ####
###  #
#@$ .#####
# *$ $ $ #
## * * . #
 # . . ###
 # . ###
 ## $#
  #  #
  ####
