#####
#   #####
# # $ $ #
# $$. *@#
# #  ** #
# ### *##
#  # .* #
##  . . #
 ##     #
  #######
