 #####
##   #####
#  # $@$ #
# #..#*  #
#  .   . #
## $.#.* #
 # $ $$# #
 #####   #
     #####
