      #####
 ######   #
 #   # $  #
##  $..#$ #
#  #**.   #
#@# *.*#  #
#   ##   ##
### $  ###
  ###  #
    ####
