    ####
#####  ##
#   $ $ ##
#   #.$. #
##  **.#@#
 #   . $ #
 #####  ##
     ####
