  ########
  #   #  #
 ##$#   .##
## .* #   #
#  .* *$# #
#   . #@$ #
#  # ##$###
####    #
   ######
