##########
#@ *.##  #
# $   $  #
###*..#  #
  #  $  ##
  # .#. #
  # $ $ #
  ####  #
     ####
