  #####
###   ###
# $ #$  #
# ....* #
#  *. $ #
## # # ##
 # $$* #
 ## @ ##
  #####
