####   ####
#  #####  #
#    $@$  #
# *.$#*.* #
## . # . ##
 # . #$. #
 ## $$  ##
  #  #  #
  #######
