   #####
 ###   ###
 # $ # * #
## $*.*  #
#  *   . #
#@  ###  #
##### ####
