 ####
##  ####
# $  $ #
# $... ##
#@*$$$* #
## ...  #
 ##   ###
  #####
