     ####
 #####  #
## $  $ #
#@$.#.* ##
# $.$ .  #
##$.*#.  #
 #      ##
 #  ######
 ####
