##########
#   #    #
# #$. .# #
#@#. * # #
# # * .# #
# #*$*$# #
# $      #
####  ####
   ####
