 ####
 #  ######
 #   $@$ #
 # **##. #
##$.$  . #
#  .# .*##
#    $  #
######  #
     ####
