  ####
###  #####
#  .$  . ##
# $*@#$*  #
## .$* .  #
 ### #  ###
   #   ##
   #####
