    #####
  ###   #
###..$. #
# $ $.$##
# #$. * #
#  . *$ #
##   # @#
 ########
