   #####
 ###   #
## .$.$#
#  .** ##
# * . * #
##   $$ #
 #  ## @#
 ########
