 #######
##  #  ##
#     $ #
# ** **@#
# * # * #
##  .  ##
 #  .$##
 ##   #
  #####
