###################
##               ##
 ##  $ $.$.$ $  ##
  ##  $.$.$.$  ##
   ## .$.$.$. ##
    ## .$.$. ##
     ## .$. ##
      ## . ##
       ##@##
      ## . ##
     ## .$. ##
    ## .$.$. ##
   ## .$.$.$. ##
  ##  $.$.$.$  ##
 ##  $ $.$.$ $  ##
##               ##
###################
