  #########
 ##   #   ##
##  # # #  ##
#  # $.$ #  #
# #  * .  # #
#   .#*# $  #
###.$#@#$.###
#  $.###.$  #
# #  . . .# #
#  #  $  #  #
##  #$#$#  ##
 ##   #   ##
  #########
