  #########
  #@   #  ####
  # $  # $$  #
  #  $ $  #  #
  ##$ #.#   ####
  ## ##.###    #
  #  *......#  #
  #  ##.##### ###
#### ##.##  # $ #
#    $   #$   # #
# #  ##  $  #   #
# ########  #####
#        # ##
########   #
       #####
