 ####
 #  #######
 #   $@#  #
 # #.#$   #
 # #* .#$ #
## #. *  ##
#  .#$# ##
#       #
####   ##
   #####
