        ####
   ######  #####
#### .. $$ #   #
#    *$ #    $ #
#  # .## .## ###
## #*.##$### #
 #     @     #
## ###$##.*# ##
#  ##. ##. #  #
#     # $* $  #
#  # $$ .. ####
####  ######
   ####
