     #####
  ####   #
  #  # $ #
  #. .@*######
 ##..*.. #   #
##  #*#    # #
#  ##.# $$#  #
# # $.    # ##
#   ## # $   #
###### $ $ $ #
     #  ######
     ####
