#############
#     #     #
# *.*$#$*.* #
# .$. @..$. #
# *.* # *.* #
# $ $ # $.$ #
### ##### ###
# $.$ # $.$ #
# *.* # $.$ #
# .$.. ..$  #
# *.*$#$$ $ #
#     #     #
#############
