#####
#   #####
#       #
##$# .$ #
#. * #$##
#.$.$  #
#.$.. ##
#$ ####
#@ #
####
