        ######
    #####    ####
 #### $  $##   @###
## $  $ # $ ### $ ##
#  $ #$## # ### $  #
# #$.............. #
#  $ ### #$####   ##
##   # $  $ # ##  #
 #####      #  ####
     ########
