   ####
 ###  #
 #@$. ##
 #$* . #
##  .  #
# $*$* #
#   . ##
###  ##
  ####
