#################
#    ....    #  #
# #.  $@$.**.   #
# #. * #$#   #$ #
#   #. #  ####  #
#####$##      $ #
    #  ## ####  #
    ## $ $ # ####
     #  $  #
     ##    #
      ######
