########
#      ##
# @ # . #
# $ $.$ #
##.#$#$##
#  . .  #
# *$# . #
##     ##
 #######
