########
#  #   #
#  * . #
# .$*$ #
## * . #
# *$*  #
# @ #  #
########
