####
#  #####
# $#...###
#    $$$ #####
# $#.*.  .#  #
#@ # $ .*.#$ #
##### $$$    #
    ## ...#$ #
     ######  #
          ####
