####
#  #######
# $$ $ $ ##
#  $@$ #  #
## #*#  # #
#  *.   # #
# $#.#. # #
#   .. #  #
### *..  ##
  ########
