   ####
   #  #
####$.######
#   $.$ #  #
# $  +     #
####$*###* #
#### .### ##
#   #.  # #
#       # #
#### #  # ##
   # ####  #
   #       #
   #  ######
   ####
