####  ####
#  ####  #
# .    . #
#  ####$ #
## #    ##
## .$*# ##
# *#$ #  #
#@$    . #
#  ####  #
####  ####
