 ########
 #   #  #
## #$# $#
#       #
#  #*# $##
#  ..*   #
####.### #
#  ..* $ #
#@ #.#  ##
# $    $#
#  ###  #
#### ####
