   ########   #####
  ##   #  #####   #
 ##    #  $       #
 #  # ##   ##### ###
##. . .## ##  $    #
#   #      #@ $  # #
#   ..####  ####$# #
######## ## $      #
          #####   ##
              #####
