        #
       # #
      #   #
     # .$. #
    # .$.$. #
   #  $.$.$  #
  # .$#$.$#$. #
 # .$.$   $.$. #
#  $.$. @ .$.$  #
 # .$.$   $.$. #
  # .$#$.$#$. #
   #  $.$.$  #
    # .$.$. #
     # .$. #
      #   #
       # #
        #
