   ####
 ###  ###
 #   *  ###
##  $.$   #
# *.*@*.* #
#   $.$  ##
###  *   #
  ###  ###
    ####
