#####
#   ##
# #  #
# #$.###
# #.$  #
#  $.# #
# #.$  #
#  $.#@#
###.$# #
  #  # #
  ##   #
   #####
