#####   ###
##  #######
##.$###   #
 # $   $  #
 #.$. # .##
 # # @ # #
##. # .$.#
#  $   $ #
#   ###$.##
#######  ##
###   #####
