                     #
                    # #
                   # # #
                  #  *  #
                 # * $ * #
                # .  $  . #
      ##########  # *#* #  ##########
      ##    #  *   * # *   *  #    ##
      # $ * . * * *  #  * * * . * $ #
      #  # *   * *   *   * *   * #  #
      # * # * *  ###*#*###  * * # * #
      #  * # *  # $ .$. $ #  * # *  #
      ##. * $  #    *#*    #  $ * .##
      #    * ##    * # *    ## *    #
      # * *  ##.* *# # #* *.##  * * #
      #* *  # .$ *   *   * $. #  * *#
     #  *  #  * # *  *  * # *  #  *  #
    #    *#    * *  # #  * *    #*    #
   # .# * #$  * * #  #  # * *  $# * #. #
  # *  *  #  *#    .$.$.    #*  #  *  * #
 #    *   *.*    # $.$.$ #    *.*   *    #
# #*$$###*#$###** #.$@$.# **###$#*###$$*# #
 #    *   *.*    # $.$.$ #    *.*   *    #
  # *  *  #  *#    .$.$.    #*  #  *  * #
   # .# * #$  * * #  #  # * *  $# * #. #
    #    *#    * *  # #  * *    #*    #
     #  *  #  * # *  *  * # *  #  *  #
      #* *  # .$ *   *   * $. #  * *#
      # * *  ##.* *# # #* *.##  * * #
      #    * ##    * # *    ## *    #
      ##. * $  #    *#*    #  $ * .##
      #  * # *  # $ .$. $ #  * # *  #
      # * # * *  ###*#*###  * * # * #
      #  # *   * *   *   * *   * #  #
      # $ * . * * *  #  * * * . * $ #
      ##    #  *   * # *   *  #    ##
      ##########  # *#* #  ##########
                # .  $  . #
                 # * $ * #
                  #  *  #
                   # # #
                    # #
                     #
