        #
       # #
      #   #
     #  $  #
    # .* *. #
   # .$ * $. #
  # .$ *.* $. #
 #  * * $ * *  #
#  $ *.$@$.* $  #
 #  * * $ * *  #
  # .$ *.* $. #
   # .$ * $. #
    # .* *. #
     #  $  #
      #   #
       # #
        #
