   #       #
  # #     # #
 #   #####   #
#  $ . $ . $  #
 #  # *#* #  #
  #. *   * .#
  # * $.$ * #
  #$# .@. #$#
  # * $.$ * #
  #. *   * .#
 #  # *#* #  #
#  $ . $ . $  #
 #   #####   #
  # #     # #
   #       #
