   #####        #####        #####
   #   #        #   #   ##   #   #
 ### .$###    ###  $#  ####  #  $###
####$. ####  ####*..####  ####$. ####
# $ $.$$  #### $.$.$*  # $# $ *.*$  #
# ... ...       . @ .        .. ..  #
#  $$.$ $ #$ #  *$.$.$ ####  $*.* $ #
#### .$####  ####..*####  #### .$####
 ###$. #  ####  #$  ###    ###$  ###
   #   #   ##   #   #        #   #
   #####        #####        #####
