   ####
####  ##
#  $ @ ###
#  ## $  ##
##.## .#  #
 # #. $ $ #
 #.# $.#  #
 #    #####
 #  ###
 ####
