           #####
          #  *  #
         ## *#* ##
        # $ .$. $ #
       #    *#*    #
     ##    * # *    ##
     ##.* *# # #* *.##
    # .$ *   *   * $. #
   #  * # *  *  * # *  #
  #    * *  # #  * *    #
 ##$  * * #  #  # * *  $##
#    *#    .$.$.    #*    #
# *.*    # $.$.$ #    *.* #
#*#$###** #.$@$.# **###$#*#
# *.*    # $.$.$ #    *.* #
#    *#    .$.$.    #*    #
 ##$  * * #  #  # * *  $##
  #    * *  # #  * *    #
   #  * # *  *  * # *  #
    # .$ *   *   * $. #
     ##.* *# # #* *.##
     ##    * # *    ##
       #    *#*    #
        # $ .$. $ #
         ## *#* ##
          #  *  #
           #####
