        #
       # #
      #   #
     #  *  #
    #  * *  #
   #  * * *  #
  #  *$* *$*  #
 #  * * . * *  #
#  * * .@. * *  #
 #  * * . * *  #
  #  *$* *$*  #
   #  * * *  #
    #  * *  #
     #  *  #
      #   #
       # #
        #
