 #######
##    ###
## * *  #
# *.$.* #
#  $@$  #
# *.$.* #
#  * * ##
###    ##
 #######
