 #######
##     ##
# * $ * #
#  # #  #
##. @ .##
#  # #  #
# * $ * #
##  *  ##
 #######
