####
#  #    #####
#  ######  @#
#  * * *    #
##  * *  *###
 #*  *  * #
 # *   * *#
 #* *   * #
 # *  *  *#
 #.  * *  ##
 #  $ * *  #
 ########  #
        #  #
        ####
