########  ######
###    #####   #
#   ##  ### $  #
# @   # ## $  ##
## ## ....*  ##
# $   $###  ##
#   #  ######
########  ##
