 ############
 #          #
## ####$    #
#    $ $$#  #
# #  $@  ## ##
#  # $ $##...#
##  # #  #.  #
 ##   ## #. .#
  ######  .###
   ##  #    #
    ## ##   #
     ########
