        ####
  #######  #
 ##     $  #
 #  #####  #
## ##  # $##
# ....$.  #
# @ ## #  #
###### #  #
    ## ## ##
    # $ $  #
    #      #
    ########
