        #
       # #
      #   #
     #  .  #
    #  * *  #
   # $*$.$*$ #
  #  * . . *  #
 #  *$.$*$.$*  #
#  . . *@* . .  #
 #  *$.$*$.$*  #
  #  * . . *  #
   # $*$.$*$ #
    #  * *  #
     #  .  #
      #   #
       # #
        #
