    ####
    #  ###
    #  . #
    #  $ #
    ## ########
 ##### . ##   #
 #  # *$*     #
##.$#.$@$.#$.##
#     *$* #  #
#   ## . #####
######## ##
     # $  #
     # .  #
     ###  #
       ####
