#####
#   # ######
#  $###..$.#
## @ ##..  #
 #  $# ..#.#
 ## $ $$$$ #
  #       ##
  #########
