   ######
   #  @ #
   # #$ #
   # .*.#
 #####$ ##
## . . . #
# $ $ $  #
# # ######
#   #
#####
