 #######
## #  ###
#  $    ##
##. * #  ##
#  * * # ##
#   *@*   #
## # * *  #
##  # * .##
 ##    $  #
  ###  # ##
   #######
