####
#  ###
#  . #
# .$.####
## *    #
 # $$@$ #
 # .#####
 #  #
 ####
